JpVocabulary.main ...
pronun:あっ	writing:null	partOfSpeech:〔叹〕	expl:哎，哎呀
pronun:ああ	writing:null	partOfSpeech:〔副〕	expl:那样
pronun:ああ	writing:null	partOfSpeech:〔叹〕	expl:啊
pronun:あいかわらず	writing:（相変わらず）	partOfSpeech:［副］	expl:照旧，依然
pronun:あいさつまわり	writing:（あいさつ回り）	partOfSpeech:null	expl:寒暄拜访
pronun:あいさつ	writing:null	partOfSpeech:［名］	expl:寒暄
pronun:あいだ	writing:（間）	partOfSpeech:〔名〕	expl:时间，期间
pronun:あいて	writing:（相手）	partOfSpeech:〔名〕	expl:对象，对方
pronun:あいます	writing:(合います)	partOfSpeech:［动1］	expl:合适，适合
pronun:あいます	writing:（会います）	partOfSpeech:〔动1〕	expl:见
pronun:あおい	writing:（青い）	partOfSpeech:〔形1〕	expl:蓝色的
pronun:あお	writing:（青）	partOfSpeech:〔名〕	expl:蓝色
pronun:あかい	writing:（赤い）	partOfSpeech:〔形1〕	expl:红
pronun:あかちゃん	writing:（赤ちゃん）	partOfSpeech:［名］	expl:婴儿，幼儿
pronun:あかるい	writing:（明るい）	partOfSpeech:〔形1〕	expl:明亮，开朗
pronun:あかるさ	writing:（明るさ）	partOfSpeech:［名］	expl:明朗，快活
pronun:あか	writing:（赤）	partOfSpeech:〔名〕	expl:红色
pronun:あがります	writing:（上がります）	partOfSpeech:［动1］	expl:提高，涨
pronun:あきます	writing:（空きます）	partOfSpeech:［动1］	expl:空，有空
pronun:あきます	writing:（開きます）	partOfSpeech:〔动1〕	expl:开
pronun:あき	writing:（秋）	partOfSpeech:［名］	expl:秋天，秋季
pronun:あくしゅ	writing:（握手）	partOfSpeech:［名］	expl:握手
pronun:あけます	writing:（開けます）	partOfSpeech:〔动2〕	expl:开，打开，开启
pronun:あげます	writing:null	partOfSpeech:〔动2〕	expl:给
pronun:あげます	writing:（挙げます）	partOfSpeech:［动2］	expl:举，举起
pronun:あげます	writing:（揚げます）	partOfSpeech:［动2］	expl:放（风筝）；扬起
pronun:あこがれ	writing:null	partOfSpeech:［名］	expl:憧憬
pronun:あさごはん	writing:（朝ご飯）	partOfSpeech:〔名〕	expl:早饭
pronun:あさって	writing:null	partOfSpeech:〔名〕	expl:后天
pronun:あさ	writing:（朝）	partOfSpeech:〔名〕	expl:早晨
pronun:あした	writing:（明日）	partOfSpeech:〔名〕	expl:明天
pronun:あし	writing:（脚）	partOfSpeech:〔名〕	expl:腿
pronun:あし	writing:（足）	partOfSpeech:〔名〕	expl:脚
pronun:あじ	writing:（味）	partOfSpeech:〔名〕	expl:口味，（食物的）味道
pronun:あす	writing:（明日）	partOfSpeech:［名］	expl:明天
pronun:あずかります	writing:（預かります）	partOfSpeech:［动1］	expl:保管，收存
pronun:あずけます	writing:(預けます)	partOfSpeech:［动2］	expl:寄存，托付
pronun:あせ	writing:（汗）	partOfSpeech:［名］	expl:汗
pronun:あそこ	writing:null	partOfSpeech:〔代〕	expl:那里，那儿
pronun:あそびます	writing:（遊びます）	partOfSpeech:〔动1〕	expl:玩，玩耍
pronun:あたたかい	writing:（暖かい）	partOfSpeech:〔形1〕	expl:暖和，温暖
pronun:あたたかい	writing:（暖かい）	partOfSpeech:〔形1〕	expl:热乎，温暖
pronun:あたためます	writing:（温めます）	partOfSpeech:［动2］	expl:热，温
pronun:あたまがいい	writing:（頭がいい）	partOfSpeech:null	expl:脑子好，聪明
pronun:あたま	writing:（頭）	partOfSpeech:〔名〕	expl:头，头脑
pronun:あたらしい	writing:（新しい）	partOfSpeech:〔形1〕	expl:新
pronun:あたります	writing:（当たります）	partOfSpeech:［动1］	expl:中（彩），抽中
pronun:あちこち	writing:null	partOfSpeech:［代］	expl:到处，处处
pronun:あちら	writing:null	partOfSpeech:〔代〕	expl:那儿，那边
pronun:あっちこっち	writing:null	partOfSpeech:［代］	expl:到处，处处
pronun:あつい	writing:null	partOfSpeech:〔形1〕	expl:热，烫
pronun:あつい	writing:（厚い）	partOfSpeech:［形1］	expl:厚
pronun:あつい	writing:（暑い）	partOfSpeech:〔形1〕	expl:（天气）热
pronun:あつさ	writing:（厚さ）	partOfSpeech:［名］	expl:厚度
pronun:あつさ	writing:（暑さ）	partOfSpeech:［名］	expl:暑热，暑气
pronun:あつまります	writing:（集まります）	partOfSpeech:［动1］	expl:聚，集合
pronun:あつめます	writing:（集めます）	partOfSpeech:〔动2〕	expl:收集
pronun:あとで	writing:（後で）	partOfSpeech:〔副〕	expl:过会儿
pronun:あと	writing:null	partOfSpeech:null	expl:～
pronun:あなた	writing:null	partOfSpeech:〔代〕	expl:你
pronun:あに	writing:（兄）	partOfSpeech:〔名〕	expl:哥哥，兄长
pronun:あね	writing:（姉）	partOfSpeech:［代］	expl:姐姐
pronun:あの	writing:null	partOfSpeech:null	expl:〔连体〕 那，那个
pronun:あのう	writing:null	partOfSpeech:〔叹〕	expl:请问，对不起
pronun:あのひと	writing:（あの人）	partOfSpeech:〔名〕	expl:那个人
pronun:あびます	writing:（浴びます）	partOfSpeech:〔动2〕	expl:淋；浇
pronun:あぶない	writing:（危ない）	partOfSpeech:〔形1〕	expl:危险
pronun:あまい	writing:（甘い）	partOfSpeech:〔形1〕	expl:甜
pronun:あまさ	writing:（甘さ）	partOfSpeech:［名］	expl:甜度
pronun:あまやどりします	writing:（雨宿り～）	partOfSpeech:［动3］	expl:避雨
pronun:あまり	writing:null	partOfSpeech:〔副〕	expl:不（太）～，不很～
pronun:あみもの	writing:（編み物）	partOfSpeech:null	expl:编制；编织品
pronun:あめ	writing:（雨）	partOfSpeech:〔名〕	expl:雨，下雨
pronun:あやまります	writing:（謝ります）	partOfSpeech:［动1］	expl:道歉
pronun:あら	writing:null	partOfSpeech:〔叹〕	expl:哎呀，咦
pronun:あらいます	writing:（洗います）	partOfSpeech:〔动1〕	expl:洗，洗涤
pronun:あらし	writing:（嵐）	partOfSpeech:［名］	expl:暴风雨，风暴
pronun:ありがとうございます	writing:null	partOfSpeech:null	expl:谢谢
pronun:あります	writing:null	partOfSpeech:〔动1〕	expl:有，在（非意志者）
pronun:あるいて	writing:（歩いて）	partOfSpeech:null	expl:步行
pronun:あるきます	writing:（歩きます）	partOfSpeech:〔动1〕	expl:步行，行走
pronun:あれ	writing:null	partOfSpeech:〔代〕	expl:那，那个
pronun:あれ	writing:null	partOfSpeech:〔叹〕	expl:哎呀，咦
pronun:あれえ	writing:null	partOfSpeech:〔叹〕	expl:咦
pronun:あわてます	writing:（慌てます）	partOfSpeech:〔动2〕	expl:慌张，惊慌，着急
pronun:あんきします	writing:（暗記～）	partOfSpeech:［动3］	expl:熟记，背诵
pronun:あんしんします	writing:（安心～）	partOfSpeech:〔动3〕	expl:安心，放心
pronun:あんぜん	writing:（安全）	partOfSpeech:〔形2〕	expl:安全
pronun:あんないします	writing:（案内～）	partOfSpeech:［动3］	expl:向导，导游
pronun:あんないじょう	writing:（案内状）	partOfSpeech:［名］	expl:通知，请帖
pronun:あんないやく	writing:（案内役）	partOfSpeech:［名］	expl:向导，导游
pronun:いい	writing:null	partOfSpeech:〔形1〕	expl:好
pronun:いいえ	writing:null	partOfSpeech:〔叹〕	expl:不，不是
pronun:いいます	writing:（言います）	partOfSpeech:〔动1〕	expl:说，讲
pronun:いうまでもなく	writing:（言うまでもなく）	partOfSpeech:null	expl:不言而喻
pronun:いえ	writing:null	partOfSpeech:〔叹〕	expl:不，不是
pronun:いえ	writing:（家）	partOfSpeech:〔名〕	expl:家
pronun:いかが	writing:null	partOfSpeech:〔副〕	expl:如何
pronun:いかにも	writing:null	partOfSpeech:［副］	expl:典型的；实在；的确
pronun:いきさき	writing:（行き先）	partOfSpeech:［名］	expl:去的地方，目的地
pronun:いきます	writing:（生きます）	partOfSpeech:［动2］	expl:活，生存
pronun:いきます	writing:（行きます）	partOfSpeech:〔动1〕	expl:去
pronun:いくら	writing:null	partOfSpeech:null	expl:多少钱
pronun:いけない	writing:null	partOfSpeech:null	expl:不行，不好，不可以
pronun:いけません	writing:null	partOfSpeech:null	expl:不行，不可以
pronun:いけん	writing:（意見）	partOfSpeech:［名］	expl:意见
pronun:いこう	writing:（以降）	partOfSpeech:［名］	expl:以后
pronun:いざかや	writing:（居酒屋）	partOfSpeech:〔名〕	expl:酒馆
pronun:いしゃ	writing:（医者）	partOfSpeech:〔名〕	expl:医生
pronun:いじめます	writing:null	partOfSpeech:［动2］	expl:欺负，折磨，欺侮
pronun:いす	writing:null	partOfSpeech:〔名〕	expl:椅子
pronun:いせき	writing:（遺跡）	partOfSpeech:［名］	expl:遗址，遗迹
pronun:いぜん	writing:（以前）	partOfSpeech:［副］	expl:以前
pronun:いそいで	writing:（急いで）	partOfSpeech:null	expl:急急忙忙地，匆忙地
pronun:いそがしい	writing:（忙しい）	partOfSpeech:〔形1〕	expl:忙，忙碌
pronun:いそぎます	writing:（急ぎます）	partOfSpeech:〔动1〕	expl:急，急忙
pronun:いたい	writing:（痛い）	partOfSpeech:〔形1〕	expl:疼，疼痛
pronun:いたします	writing:null	partOfSpeech:［动1］	expl:（自谦）做，干
pronun:いただきます	writing:null	partOfSpeech:null	expl:我吃了，（我）开始吃了
pronun:いただきます	writing:null	partOfSpeech:［动1］	expl:（自谦）吃，喝；得到
pronun:いたります	writing:（至ります）	partOfSpeech:［动1］	expl:到达，达到
pronun:いちばん	writing:null	partOfSpeech:〔副〕	expl:最，第一
pronun:いっさくねん	writing:（一昨年）	partOfSpeech:［名］	expl:前年
pronun:いっしょうけんめい	writing:(一生懸命)	partOfSpeech:［副］	expl:拼命地，努力地
pronun:いっしょに	writing:null	partOfSpeech:〔副〕	expl:一起
pronun:いってきます	writing:null	partOfSpeech:null	expl:我走了
pronun:いってまいります	writing:null	partOfSpeech:null	expl:我走了
pronun:いってらっしゃい	writing:null	partOfSpeech:null	expl:你走好
pronun:いっぱい	writing:null	partOfSpeech:〔副〕	expl:满
pronun:いっぱん	writing:（一般）	partOfSpeech:［名］	expl:一般
pronun:いつ	writing:null	partOfSpeech:〔疑〕	expl:什么时候
pronun:いつも	writing:null	partOfSpeech:〔副〕	expl:经常，总是
pronun:いなか	writing:（田舎）	partOfSpeech:［名］	expl:乡下，农村
pronun:いぬ	writing:（犬）	partOfSpeech:〔名〕	expl:狗
pronun:いね	writing:（稲）	partOfSpeech:［名］	expl:稻子
pronun:いまから	writing:（今から）	partOfSpeech:null	expl:从现在起
pronun:います	writing:null	partOfSpeech:〔动2〕	expl:有，在（具意志者）
pronun:いま	writing:（今）	partOfSpeech:〔名〕	expl:现在
pronun:いま	writing:（居間）	partOfSpeech:〔名〕	expl:起居室
pronun:いみ	writing:（意味）	partOfSpeech:［名］	expl:意思
pronun:いもうと	writing:（妹）	partOfSpeech:〔名〕	expl:妹妹
pronun:いや	writing:null	partOfSpeech:〔叹〕	expl:不
pronun:いやあ	writing:null	partOfSpeech:［叹］	expl:哎呀
pronun:いらいします	writing:（依頼～）	partOfSpeech:［动3］	expl:委托，请求
pronun:いらっしゃいます	writing:null	partOfSpeech:［动1］	expl:（尊他）去，来，在
pronun:いらっしゃいませ	writing:null	partOfSpeech:null	expl:欢迎光临
pronun:いりくみます	writing:（入り組みます）	partOfSpeech:[动1]	expl:错综复杂
pronun:いりぐち	writing:（入り口）	partOfSpeech:〔名〕	expl:入口
pronun:いります	writing:（要ります）	partOfSpeech:［动1］	expl:要
pronun:いれます	writing:（入れます）	partOfSpeech:［动2］	expl:放入，放进
pronun:いろいろ	writing:null	partOfSpeech:〔副〕	expl:各种各样
pronun:いろえんぴつ	writing:（色鉛筆）	partOfSpeech:［名］	expl:彩色铅笔
pronun:いろんな	writing:null	partOfSpeech:null	expl:［连体］各种各样的
pronun:いろ	writing:（色）	partOfSpeech:〔名〕	expl:颜色
pronun:いわいます	writing:（祝います）	partOfSpeech:［动1］	expl:祝贺
pronun:いんしょくてん	writing:（飲食店）	partOfSpeech:［名］	expl:饮食店
pronun:ううん	writing:null	partOfSpeech:〔叹〕	expl:不
pronun:うえのどうぶつえん	writing:（上野動物園）	partOfSpeech:［专］	expl:上野动物园
pronun:うえ	writing:（上）	partOfSpeech:〔名〕	expl:上面
pronun:うかがいます	writing:（伺います）	partOfSpeech:［动1］	expl:（自谦）去；来；问；拜访；请教
pronun:うかびます	writing:（浮かびます）	partOfSpeech:［动1］	expl:想起，浮，浮现
pronun:うけつけ	writing:（受付）	partOfSpeech:〔名〕	expl:接待处
pronun:うけます	writing:（受けます）	partOfSpeech:［动2］	expl:感受，受到
pronun:うごかします	writing:（動かします）	partOfSpeech:[动1]	expl:开动，移动，摇动
pronun:うごきます	writing:（動きます）	partOfSpeech:［动1］	expl:运转，转动
pronun:うしろ	writing:（後ろ）	partOfSpeech:〔名〕	expl:后，后面
pronun:うすい	writing:（薄い）	partOfSpeech:〔形1〕	expl:（口味）轻；薄
pronun:うたいます	writing:（歌います）	partOfSpeech:〔动1〕	expl:唱，歌唱
pronun:うた	writing:（歌）	partOfSpeech:〔名〕	expl:歌，歌曲
pronun:うち	writing:null	partOfSpeech:〔名〕	expl:家
pronun:うちあわせ	writing:（打ち合わせ）	partOfSpeech:〔名〕	expl:事先商量，碰头，商洽
pronun:うちゅうひこうし	writing:（宇宙飛行士）	partOfSpeech:［名］	expl:宇航员
pronun:うっかり	writing:null	partOfSpeech:［副］	expl:不留神，不注意
pronun:うつくしい	writing:（美しい）	partOfSpeech:［形1］	expl:美丽
pronun:うつくしさ	writing:（美しさ）	partOfSpeech:［名］	expl:美好，美丽程度
pronun:うでどけい	writing:（腕時計）	partOfSpeech:［名］	expl:手表
pronun:うどん	writing:null	partOfSpeech:〔名〕	expl:面条
pronun:うまい	writing:null	partOfSpeech:［形1］	expl:高明，好吃，可口
pronun:うまく	writing:null	partOfSpeech:［副］	expl:高明地，很好地
pronun:うまれます	writing:（生まれます）	partOfSpeech:［动2］	expl:出生，诞生
pronun:うみ	writing:（海）	partOfSpeech:〔名〕	expl:大海
pronun:うりあげ	writing:（うりあげ）	partOfSpeech:［名］	expl:销售额，营业额
pronun:うりば	writing:（売り場）	partOfSpeech:〔名〕	expl:柜台，出售处
pronun:うります	writing:（売ります）	partOfSpeech:〔动1〕	expl:卖，销售
pronun:うるさい	writing:null	partOfSpeech:〔形1〕	expl:闹，使人心烦
pronun:うれしい	writing:null	partOfSpeech:〔形1〕	expl:高兴
pronun:うれます	writing:（売れます）	partOfSpeech:［动2］	expl:好卖，畅销
pronun:うれゆき	writing:（売れ行き）	partOfSpeech:［名］	expl:销路，销售（情况）
pronun:うわあ	writing:null	partOfSpeech:［叹］	expl:哇
pronun:うわさ	writing:null	partOfSpeech:［名］	expl:传说，风言风语
pronun:うん	writing:null	partOfSpeech:〔叹〕	expl:嗯
pronun:うんてんしゅ	writing:（運転手）	partOfSpeech:［名］	expl:司机
pronun:うんてん	writing:（運転）	partOfSpeech:〔名〕	expl:开车
pronun:うんどうかい	writing:（運動会）	partOfSpeech:［名］	expl:运动会
pronun:うんどうします	writing:（運動～）	partOfSpeech:〔动3〕	expl:运动
pronun:うーん	writing:null	partOfSpeech:〔叹〕	expl:嗯……，这个……
pronun:えいかいわ	writing:（英会話）	partOfSpeech:〔名〕	expl:英语会话
pronun:えいが	writing:（映画）	partOfSpeech:〔名〕	expl:电影
pronun:えいきょう	writing:（影響）	partOfSpeech:［名］	expl:影响
pronun:えいぎょうか	writing:（営業課）	partOfSpeech:[名]	expl:营业科
pronun:えいぎょうぶ	writing:（営業部）	partOfSpeech:〔名〕	expl:营业部
pronun:えいぎょう	writing:（営業）	partOfSpeech:［名］	expl:营业
pronun:えいご	writing:（英語）	partOfSpeech:〔名〕	expl:英语
pronun:えいじしんぶん	writing:（英字新聞）	partOfSpeech:［名］	expl:英文报纸
pronun:えいせいほうそう	writing:（衛星放送）	partOfSpeech:［名］	expl:卫星广播
pronun:ええ	writing:null	partOfSpeech:〔叹〕	expl:（应答）嗯，是
pronun:ええと	writing:null	partOfSpeech:〔叹〕	expl:啊，嗯
pronun:えきまえ	writing:（駅前）	partOfSpeech:〔名〕	expl:车站一带
pronun:えき	writing:（駅）	partOfSpeech:〔名〕	expl:车站
pronun:えっ	writing:null	partOfSpeech:〔叹〕	expl:啊
pronun:えほん	writing:（絵本）	partOfSpeech:[名]	expl:图画书，连环画
pronun:えらい	writing:（偉い）	partOfSpeech:［形1］	expl:了不起，伟大
pronun:えらびます	writing:（選びます）	partOfSpeech:〔动1〕	expl:挑选，选择
pronun:えんだか	writing:（円高）	partOfSpeech:［名］	expl:日元升值
pronun:えんとつ	writing:（煙突）	partOfSpeech:［名］	expl:烟筒
pronun:えんぴつ	writing:（鉛筆）	partOfSpeech:〔名〕	expl:铅笔
pronun:えんりょします	writing:（遠慮～）	partOfSpeech:［动3］	expl:客气
pronun:えんりょなく	writing:(遠慮なく)	partOfSpeech:null	expl:不客气
pronun:え	writing:（絵）	partOfSpeech:〔名〕	expl:画儿
pronun:おいくつ	writing:null	partOfSpeech:null	expl:多大
pronun:おいしい	writing:null	partOfSpeech:〔形1〕	expl:好吃，可口
pronun:おいしさ	writing:null	partOfSpeech:［名］	expl:美味，好吃程度
pronun:おいでになります	writing:null	partOfSpeech:［动1］	expl:（尊他）去，来，在
pronun:おい	writing:null	partOfSpeech:［叹］	expl:哎，喂
pronun:おうせつしつ	writing:（応接室）	partOfSpeech:［名］	expl:会客室
pronun:おうだんきんし	writing:（横断禁止）	partOfSpeech:［名］	expl:禁止横穿
pronun:おうだんほどう	writing:（横断歩道）	partOfSpeech:〔名〕	expl:人行横道
pronun:おう	writing:（王）	partOfSpeech:〔专〕	expl:王
pronun:おおあめ	writing:（大雨）	partOfSpeech:［名］	expl:大雨
pronun:おおい	writing:（多い）	partOfSpeech:〔形1〕	expl:多
pronun:おおがたスーパー	writing:（大型～）	partOfSpeech:［名］	expl:大型超市
pronun:おおきい	writing:（大きい）	partOfSpeech:〔形1〕	expl:大
pronun:おおきさ	writing:（大きさ）	partOfSpeech:［名］	expl:大小
pronun:おおきな	writing:（大きな）	partOfSpeech:null	expl:［连体］大的
pronun:おおく	writing:（多く）	partOfSpeech:［名］	expl:多，多数
pronun:おおさか	writing:（大阪）	partOfSpeech:〔专〕	expl:大阪
pronun:おおぜい	writing:（大勢）	partOfSpeech:［名］	expl:许多，众多
pronun:おおた	writing:（太田）	partOfSpeech:〔专〕	expl:太田
pronun:おおはば	writing:（大幅）	partOfSpeech:［形2］	expl:大幅（度），广泛
pronun:おかあさん	writing:（お母さん）	partOfSpeech:〔名〕	expl:母亲
pronun:おかえりなさい	writing:（お帰りなさい）	partOfSpeech:null	expl:你回来了
pronun:おかげさまで	writing:null	partOfSpeech:null	expl:托您的福
pronun:おかしい	writing:null	partOfSpeech:〔形1〕	expl:可笑，滑稽
pronun:おかしい	writing:null	partOfSpeech:［形1］	expl:奇怪，可笑，不正常
pronun:おかし	writing:（お菓子）	partOfSpeech:〔名〕	expl:点心
pronun:おかね	writing:（お金）	partOfSpeech:〔名〕	expl:钱，金钱
pronun:おかゆ	writing:（お粥）	partOfSpeech:〔名〕	expl:粥
pronun:おきなわ	writing:（沖縄）	partOfSpeech:［专］	expl:冲绳
pronun:おきます	writing:（置きます）	partOfSpeech:〔动1〕	expl:放置
pronun:おきます	writing:（起きます）	partOfSpeech:〔动2〕	expl:起床
pronun:おきゃくさま	writing:（お客様）	partOfSpeech:〔名〕	expl:来宾
pronun:おきゃくさん	writing:（お客さん）	partOfSpeech:［名］	expl:顾客，客人
pronun:おきをつけて	writing:（お気をつけて）	partOfSpeech:null	expl:小心点儿
pronun:おき	writing:（沖）	partOfSpeech:［名］	expl:海上，湖心
pronun:おくさん	writing:（奥さん）	partOfSpeech:〔名〕	expl:夫人，（别人的）爱人
pronun:おくじょう	writing:（屋上）	partOfSpeech:［名］	expl:屋顶上，屋顶
pronun:おくります	writing:（送ります）	partOfSpeech:〔动1〕	expl:寄
pronun:おくれます	writing:（遅れます）	partOfSpeech:〔动2〕	expl:迟到
pronun:おく	writing:（奥）	partOfSpeech:［名］	expl:里头，内部；深处
pronun:おげんきで	writing:（お元気で）	partOfSpeech:null	expl:请多保重
pronun:おこさん	writing:（お子さん）	partOfSpeech:［名］	expl:您的孩子
pronun:おこします	writing:（起こします）	partOfSpeech:［动1］	expl:叫醒，唤醒
pronun:おこないます	writing:（行います）	partOfSpeech:[动1]	expl:开，举行
pronun:おこります	writing:（怒ります）	partOfSpeech:［动1］	expl:生气
pronun:おさきにしつれいします	writing:（お先に失礼します）	partOfSpeech:null	expl:我先走了，我先告辞了
pronun:おさけ	writing:（お酒）	partOfSpeech:〔名〕	expl:酒，酒类
pronun:おさら	writing:（お皿）	partOfSpeech:〔名〕	expl:盘子
pronun:おしえます	writing:（教えます）	partOfSpeech:〔动2〕	expl:教
pronun:おします	writing:（押します）	partOfSpeech:［动1］	expl:按，推，挤
pronun:おしょうがつ	writing:（お正月）	partOfSpeech:〔名〕	expl:过年，新年
pronun:おしょくじけん	writing:（汚職事件）	partOfSpeech:［名］	expl:贪污事件
pronun:おしるこ	writing:（お汁粉）	partOfSpeech:〔名〕	expl:年糕小豆汤
pronun:おじいさん	writing:null	partOfSpeech:［代］	expl:爷爷；老大爷
pronun:おじぎ	writing:（お辞儀）	partOfSpeech:［名］	expl:鞠躬
pronun:おじゃましました	writing:（お邪魔しました）	partOfSpeech:null	expl:打扰了
pronun:おじゃまします	writing:（お邪魔します）	partOfSpeech:null	expl:打扰了
pronun:おじゃまします	writing:（お邪魔～）	partOfSpeech:［动3］	expl:打扰，拜访
pronun:おじょうさん	writing:（お嬢さん）	partOfSpeech:〔名〕	expl:令爱
pronun:おじ	writing:null	partOfSpeech:［名］	expl:叔叔，伯伯，舅舅
pronun:おすもうさん	writing:（お相撲さん）	partOfSpeech:［名］	expl:相扑选手
pronun:おせわになりました	writing:（お世話になりました）	partOfSpeech:null	expl:承蒙照顾
pronun:おそい	writing:（遅い）	partOfSpeech:〔形1〕	expl:晚，慢
pronun:おたく	writing:（お宅）	partOfSpeech:〔名〕	expl:府上，（您）家
pronun:おだいじに	writing:（お大事に）	partOfSpeech:null	expl:请多保重
pronun:おちます	writing:（落ちます）	partOfSpeech:[动2]	expl:落下，掉
pronun:おちゃ	writing:（お茶）	partOfSpeech:〔名〕	expl:茶
pronun:おっしゃいます	writing:null	partOfSpeech:［动1］	expl:（尊他）说，讲
pronun:おつかれさまでした	writing:（お疲れ様でした）	partOfSpeech:null	expl:够累的
pronun:おつり	writing:null	partOfSpeech:［名］	expl:找的零钱
pronun:おてあらい	writing:（お手洗い）	partOfSpeech:［名］	expl:洗手间，厕所
pronun:おてつだい	writing:（お手伝い）	partOfSpeech:［名］	expl:帮忙，帮助
pronun:おとうと	writing:（弟）	partOfSpeech:〔名〕	expl:弟弟
pronun:おとこ	writing:（男）	partOfSpeech:〔名〕	expl:男
pronun:おとします	writing:（落とします）	partOfSpeech:〔动1〕	expl:掉，使落下
pronun:おとしより	writing:（お年寄り）	partOfSpeech:［名］	expl:老年人
pronun:おととい	writing:null	partOfSpeech:〔名〕	expl:前天
pronun:おととし	writing:null	partOfSpeech:［名］	expl:前年
pronun:おとなしい	writing:null	partOfSpeech:［形1］	expl:温顺，老实
pronun:おとな	writing:（大人）	partOfSpeech:［名］	expl:大人，成人
pronun:おと	writing:（音）	partOfSpeech:〔名〕	expl:声音，响声
pronun:おどります	writing:（踊ります）	partOfSpeech:［动1］	expl:跳舞
pronun:おどろきます	writing:（驚きます）	partOfSpeech:［动1］	expl:惊讶，吃惊
pronun:おなか	writing:null	partOfSpeech:〔名〕	expl:肚子
pronun:おなかがいっぱいです	writing:null	partOfSpeech:null	expl:吃饱，饱
pronun:おなかがすきます	writing:null	partOfSpeech:null	expl:肚子饿
pronun:おなじ	writing:（同じ）	partOfSpeech:［形2］	expl:一样，相同
pronun:おにいさん	writing:（お兄さん）	partOfSpeech:〔名〕	expl:哥哥
pronun:おねがいします	writing:（お願いします）	partOfSpeech:null	expl:拜托了
pronun:おの	writing:（小野）	partOfSpeech:〔专〕	expl:小野
pronun:おはよう	writing:null	partOfSpeech:null	expl:你早
pronun:おばあさん	writing:null	partOfSpeech:［代］	expl:奶奶；老奶奶
pronun:おひさしぶりです	writing:（お久しぶりです）	partOfSpeech:null	expl:好久不见
pronun:おふろにはいります	writing:（お風呂にはいります）	partOfSpeech:null	expl:洗澡
pronun:おふろ	writing:（お風呂）	partOfSpeech:〔名〕	expl:澡堂，浴室
pronun:おへんじ	writing:（お返事）	partOfSpeech:［名］	expl:回信
pronun:おべんとう	writing:（お弁当）	partOfSpeech:〔名〕	expl:盒饭
pronun:おぼえます	writing:（覚えます）	partOfSpeech:［动2］	expl:记住，掌握
pronun:おまたせしました	writing:（お待たせしました）	partOfSpeech:null	expl:让您久等了
pronun:おまつり	writing:（お祭り）	partOfSpeech:［名］	expl:祭日，节日
pronun:おみせ	writing:（お店）	partOfSpeech:〔名〕	expl:餐馆；商店
pronun:おみやげ	writing:（お土産）	partOfSpeech:〔名〕	expl:礼物
pronun:おもいだします	writing:（思い出します）	partOfSpeech:［动1］	expl:想起，想出
pronun:おもいます	writing:（思います）	partOfSpeech:〔动1〕	expl:想，思考
pronun:おもい	writing:（重い）	partOfSpeech:〔形1〕	expl:重，沉重
pronun:おもさ	writing:（重さ）	partOfSpeech:［名］	expl:重量
pronun:おもしろい	writing:null	partOfSpeech:〔形1〕	expl:有趣，有意思
pronun:おもしろさ	writing:null	partOfSpeech:［名］	expl:趣味，有趣程度
pronun:おもちゃ	writing:null	partOfSpeech:〔名〕	expl:玩具
pronun:おやこどん	writing:（親子丼）	partOfSpeech:〔名〕	expl:鸡肉鸡蛋盖饭
pronun:おや	writing:（親）	partOfSpeech:［名］	expl:双亲，父母
pronun:おゆ	writing:（お湯）	partOfSpeech:〔名〕	expl:热水，开水
pronun:およぎます	writing:（泳ぎます）	partOfSpeech:〔动1〕	expl:游泳
pronun:おります	writing:（下ります）	partOfSpeech:［动2］	expl:下，下来
pronun:おります	writing:（降ります）	partOfSpeech:〔动2〕	expl:下（车，山）
pronun:おります	writing:null	partOfSpeech:［动1］	expl:在
pronun:おれます	writing:（折れます）	partOfSpeech:［动2］	expl:折，断；拐弯
pronun:おろします	writing:（下ろします）	partOfSpeech:〔动1〕	expl:取，卸货
pronun:おわかれ	writing:（お別れ）	partOfSpeech:〔名〕	expl:分别，分手
pronun:おわります	writing:（終わります）	partOfSpeech:〔动1〕	expl:结束
pronun:おわり	writing:（終わり）	partOfSpeech:〔名〕	expl:结束
pronun:おんがくかい	writing:（音楽会）	partOfSpeech:［名］	expl:音乐会
pronun:おんがく	writing:（音楽）	partOfSpeech:〔名〕	expl:音乐
pronun:おんせん	writing:（温泉）	partOfSpeech:〔名〕	expl:温泉
pronun:おんな	writing:（女）	partOfSpeech:〔名〕	expl:女
pronun:お	writing:null	partOfSpeech:null	expl:～
pronun:かいいん	writing:（会員）	partOfSpeech:［名］	expl:会员
pronun:かいがいりょこう	writing:（海外旅行）	partOfSpeech:［名］	expl:海外旅行
pronun:かいがい	writing:（海外）	partOfSpeech:［名］	expl:海外
pronun:かいがん	writing:（海岸）	partOfSpeech:〔名〕	expl:海岸
pronun:かいぎしつ	writing:（会議室）	partOfSpeech:〔名〕	expl:会议室
pronun:かいぎじょう	writing:（会議場）	partOfSpeech:［名］	expl:会场
pronun:かいぎ	writing:（会議）	partOfSpeech:〔名〕	expl:会议
pronun:かいしゃいん	writing:（会社員）	partOfSpeech:〔名〕	expl:公司职员
pronun:かいしゃ	writing:（会社）	partOfSpeech:〔名〕	expl:公司
pronun:かいじょう	writing:（会場）	partOfSpeech:［名］	expl:会场
pronun:かいすうけん	writing:（回数券）	partOfSpeech:［名］	expl:回数券
pronun:かいせつ	writing:（開設）	partOfSpeech:［名］	expl:开设
pronun:かいだん	writing:（階段）	partOfSpeech:［名］	expl:楼梯，台阶
pronun:かいちくします	writing:（改築～）	partOfSpeech:［动3］	expl:改建
pronun:かいつうします	writing:（開通～）	partOfSpeech:［动3］	expl:开通
pronun:かいはつします	writing:（開発～）	partOfSpeech:［动3］	expl:开发
pronun:かいひ	writing:（会費）	partOfSpeech:［名］	expl:会费
pronun:かいます	writing:（買います）	partOfSpeech:〔动1〕	expl:买
pronun:かいます	writing:（飼います）	partOfSpeech:［动1］	expl:饲养
pronun:かいものします	writing:（買い物～）	partOfSpeech:〔动3〕	expl:买东西
pronun:かえします	writing:（返します）	partOfSpeech:〔动1〕	expl:归还
pronun:かえり	writing:(帰り)	partOfSpeech:［名］	expl:回程，返回，回家
pronun:かえります	writing:（帰ります）	partOfSpeech:〔动1〕	expl:回来，回去
pronun:かお	writing:（顔）	partOfSpeech:〔名〕	expl:脸，颜面
pronun:かかります	writing:null	partOfSpeech:〔动1〕	expl:花费（时间，金钱）
pronun:かかります	writing:（掛かります）	partOfSpeech:［动1］	expl:挂，悬挂
pronun:かかり	writing:（係）	partOfSpeech:［名］	expl:工作人员，主管人员
pronun:かきげんきん	writing:（火気厳禁）	partOfSpeech:〔名〕	expl:严禁烟火
pronun:かきます	writing:null	partOfSpeech:〔动1〕	expl:画
pronun:かきます	writing:（書きます）	partOfSpeech:〔动1〕	expl:写
pronun:かぎ	writing:null	partOfSpeech:〔名〕	expl:钥匙，锁
pronun:かぐ	writing:（家具）	partOfSpeech:［名］	expl:家具
pronun:かけます	writing:null	partOfSpeech:〔动2〕	expl:打（电话）
pronun:かけます	writing:（掛けます）	partOfSpeech:[动2]	expl:挂
pronun:かさ	writing:（傘）	partOfSpeech:〔名〕	expl:伞
pronun:かざります	writing:(飾ります)	partOfSpeech:［动1］	expl:装饰
pronun:かしきり	writing:（貸し切り）	partOfSpeech:［名］	expl:包租
pronun:かしこまりました	writing:null	partOfSpeech:null	expl:我知道了
pronun:かします	writing:（貸します）	partOfSpeech:〔动1〕	expl:借出，借给
pronun:かしゅ	writing:（歌手）	partOfSpeech:〔名〕	expl:歌手
pronun:かじ	writing:（家事）	partOfSpeech:［名］	expl:家务活
pronun:かじ	writing:（火事）	partOfSpeech:〔名〕	expl:火灾
pronun:かせぎます	writing:(稼ぎます)	partOfSpeech:［动1］	expl:挣钱，赚钱
pronun:かぜがつよい	writing:（風が強い）	partOfSpeech:null	expl:风大
pronun:かぜをひきます	writing:（風邪を引きます）	partOfSpeech:null	expl:感冒
pronun:かぜ	writing:（風邪）	partOfSpeech:〔名〕	expl:感冒
pronun:かぜ	writing:（風）	partOfSpeech:［名］	expl:风
pronun:かぞく	writing:（家族）	partOfSpeech:〔名〕	expl:家人，家属
pronun:かたい	writing:（硬い）	partOfSpeech:［形1］	expl:硬
pronun:かたち	writing:（形）	partOfSpeech:〔名〕	expl:造型，形状，形式
pronun:かたづけます	writing:（片づけます）	partOfSpeech:〔动2〕	expl:收拾，整理
pronun:かた	writing:（方）	partOfSpeech:〔名〕	expl:（敬称）位，人
pronun:かちます	writing:（勝ちます）	partOfSpeech:[动1]	expl:取胜，获胜
pronun:かちょう	writing:（課長）	partOfSpeech:〔名〕	expl:科长
pronun:かとう	writing:（加藤）	partOfSpeech:［专］	expl:加藤
pronun:かど	writing:（角）	partOfSpeech:〔名〕	expl:拐角
pronun:かなしい	writing:（悲しい）	partOfSpeech:［形1］	expl:悲伤，悲哀
pronun:かならず	writing:（必ず）	partOfSpeech:〔副〕	expl:一定，必定
pronun:かなり	writing:null	partOfSpeech:［副］	expl:颇，相当
pronun:かのじょ	writing:（彼女）	partOfSpeech:［代］	expl:她
pronun:かばん	writing:null	partOfSpeech:〔名〕	expl:包，公文包
pronun:かぶきやくしゃ	writing:（歌舞伎役者）	partOfSpeech:［名］	expl:歌舞伎演员
pronun:かぶき	writing:（歌舞伎）	partOfSpeech:〔名〕	expl:歌舞伎
pronun:かぶります	writing:null	partOfSpeech:［动1］	expl:戴
pronun:かべ	writing:（壁）	partOfSpeech:〔名〕	expl:墙壁
pronun:かまいません	writing:null	partOfSpeech:null	expl:没关系，不要紧
pronun:かみひこうき	writing:（紙飛行機）	partOfSpeech:〔名〕	expl:纸折的飞机
pronun:かみます	writing:null	partOfSpeech:［动1］	expl:咬，嚼
pronun:かみ	writing:（紙）	partOfSpeech:〔名〕	expl:纸
pronun:かみ	writing:（髪）	partOfSpeech:〔名〕	expl:头发
pronun:かよいます	writing:（通います）	partOfSpeech:［动1］	expl:上学，来往
pronun:かようび	writing:（火曜日）	partOfSpeech:〔名〕	expl:星期二
pronun:からあげ	writing:（唐揚げ）	partOfSpeech:〔名〕	expl:炸鸡，油炸食品
pronun:からい	writing:（辛い）	partOfSpeech:〔形1〕	expl:辣
pronun:からだ	writing:（体）	partOfSpeech:〔名〕	expl:身体
pronun:から	writing:（空）	partOfSpeech:［名］	expl:空
pronun:かります	writing:（借ります）	partOfSpeech:〔动2〕	expl:（向别人）借
pronun:かるいもの	writing:（軽い物）	partOfSpeech:null	expl:清淡的或少量的食物
pronun:かるい	writing:（軽い）	partOfSpeech:〔形1〕	expl:轻巧，轻，轻松，轻微
pronun:かれます	writing:（枯れます）	partOfSpeech:［动2］	expl:枯萎；干燥
pronun:かれ	writing:（彼）	partOfSpeech:［代］	expl:他
pronun:かわいい	writing:null	partOfSpeech:〔形1〕	expl:可爱
pronun:かわきます	writing:（乾きます）	partOfSpeech:［动1］	expl:干，干燥
pronun:かわきます	writing:（渇きます）	partOfSpeech:〔动1〕	expl:渴
pronun:かわった	writing:（変わった）	partOfSpeech:null	expl:怪
pronun:かわります	writing:（変わります）	partOfSpeech:［动1］	expl:变，转变
pronun:かわ	writing:（川）	partOfSpeech:［名］	expl:河，河流
pronun:かわ	writing:（皮）	partOfSpeech:〔名〕	expl:皮
pronun:かわ	writing:（革）	partOfSpeech:〔名〕	expl:革，皮革
pronun:かんがえます	writing:（考えます）	partOfSpeech:〔动2〕	expl:考虑
pronun:かんがえ	writing:（考え）	partOfSpeech:［名］	expl:想法，思想
pronun:かんきゃく	writing:（観客）	partOfSpeech:［名］	expl:观众
pronun:かんき	writing:（換気）	partOfSpeech:［名］	expl:换气
pronun:かんげいかい	writing:（歓迎会）	partOfSpeech:〔名〕	expl:欢迎会
pronun:かんげいします	writing:(歓迎～)	partOfSpeech:［动3］	expl:欢迎
pronun:かんこうきゃく	writing:（観光客）	partOfSpeech:〔名〕	expl:游客
pronun:かんこうスポット	writing:（観光～）	partOfSpeech:［名］	expl:旅游点
pronun:かんこくご	writing:（韓国語）	partOfSpeech:〔名〕	expl:韩语
pronun:かんこくじん	writing:（韓国人）	partOfSpeech:〔名〕	expl:韩国人
pronun:かんこく	writing:（韓国）	partOfSpeech:〔专〕	expl:韩国
pronun:かんさいべん	writing:（関西弁）	partOfSpeech:［名］	expl:关西话，关西方言
pronun:かんさんします	writing:（換算～）	partOfSpeech:［动3］	expl:换算
pronun:かんしゃします	writing:（感謝～）	partOfSpeech:〔动3〕	expl:感谢
pronun:かんじます	writing:（感じます）	partOfSpeech:［动2］	expl:感觉，觉得
pronun:かんじゃ	writing:（患者）	partOfSpeech:［名］	expl:病人，患者
pronun:かんじ	writing:（感じ）	partOfSpeech:［名］	expl:感觉
pronun:かんじ	writing:（漢字）	partOfSpeech:［名］	expl:汉字
pronun:かんせいします	writing:（完成～）	partOfSpeech:［动3］	expl:完成
pronun:かんぜん	writing:（完全）	partOfSpeech:［形2］	expl:充分，完全
pronun:かんたん	writing:（簡単）	partOfSpeech:〔形2〕	expl:简单
pronun:かんとく	writing:（監督）	partOfSpeech:［名］	expl:教练，领队
pronun:かんばん	writing:（看板）	partOfSpeech:〔名〕	expl:牌子
pronun:かんぱいします	writing:（乾杯～）	partOfSpeech:［动3］	expl:干杯
pronun:かんびょうします	writing:（看病～）	partOfSpeech:［动3］	expl:护理
pronun:かんりします	writing:（管理～）	partOfSpeech:［动3］	expl:管理
pronun:がいこくじん	writing:（外国人）	partOfSpeech:〔名〕	expl:外国人
pronun:がいこく	writing:（外国）	partOfSpeech:〔名〕	expl:外国
pronun:がいしゅつします	writing:（外出～）	partOfSpeech:〔动3〕	expl:外出，出去
pronun:がくしゃ	writing:（学者）	partOfSpeech:〔名〕	expl:学者
pronun:がくせい	writing:（学生）	partOfSpeech:〔名〕	expl:（大）学生
pronun:がっこう	writing:（学校）	partOfSpeech:〔名〕	expl:学校
pronun:がら	writing:（柄）	partOfSpeech:［名］	expl:花纹，花样
pronun:がんばります	writing:（頑張ります）	partOfSpeech:［动1］	expl:拼命努力
pronun:きいろ	writing:（黄色）	partOfSpeech:［名］	expl:黄色，黄颜色
pronun:きえます	writing:（消えます）	partOfSpeech:[动2]	expl:熄灭，消失
pronun:きおん	writing:（気温）	partOfSpeech:［名］	expl:气温
pronun:きかい	writing:（機会）	partOfSpeech:［名］	expl:机会
pronun:きかい	writing:（機械）	partOfSpeech:〔名〕	expl:机械，机器
pronun:きかくあん	writing:（企画案）	partOfSpeech:［名］	expl:策划方案
pronun:きかくしょ	writing:（企画書）	partOfSpeech:［名］	expl:计划书
pronun:きかく	writing:（企画）	partOfSpeech:［名］	expl:策划，计划
pronun:きかん	writing:（期間）	partOfSpeech:〔名〕	expl:时间，期间
pronun:きがつきます	writing:（気がつきます）	partOfSpeech:null	expl:察觉
pronun:ききます	writing:（効きます）	partOfSpeech:［动1］	expl:有效，起作用
pronun:ききます	writing:（聞きます）	partOfSpeech:〔动1〕	expl:听
pronun:きぎょう	writing:（企業）	partOfSpeech:〔名〕	expl:企业
pronun:きけん	writing:（危険）	partOfSpeech:［形2］	expl:危险
pronun:きげん	writing:（機嫌）	partOfSpeech:［名］	expl:情绪，心情
pronun:きこえます	writing:（聞こえます）	partOfSpeech:［动2］	expl:听到，听得见
pronun:きこくします	writing:（帰国～）	partOfSpeech:〔动3〕	expl:回国
pronun:きさく	writing:（気さく）	partOfSpeech:［形2］	expl:爽快，坦率
pronun:きじ	writing:（生地）	partOfSpeech:〔名〕	expl:布料，衣料
pronun:きじ	writing:（記事）	partOfSpeech:〔名〕	expl:报道
pronun:きず	writing:（傷）	partOfSpeech:［名］	expl:瑕疵；创伤
pronun:きせつ	writing:（季節）	partOfSpeech:〔名〕	expl:季节
pronun:きそく	writing:（規則）	partOfSpeech:［名］	expl:规则
pronun:きたいします	writing:（期待～）	partOfSpeech:［动3］	expl:希望，期待
pronun:きたない	writing:（汚い）	partOfSpeech:〔形1〕	expl:脏
pronun:きちょう	writing:（貴重）	partOfSpeech:［形2］	expl:贵重
pronun:きちんと	writing:null	partOfSpeech:［副］	expl:好好地；正经地
pronun:きっさてん	writing:（喫茶店）	partOfSpeech:〔名〕	expl:咖啡馆
pronun:きって	writing:（切手）	partOfSpeech:〔名〕	expl:邮票
pronun:きっと	writing:null	partOfSpeech:［副］	expl:一定
pronun:きっぷ	writing:（切符）	partOfSpeech:〔名〕	expl:票（券）
pronun:きつえんしゃ	writing:（喫煙者）	partOfSpeech:［名］	expl:吸烟者
pronun:きづきます	writing:（気づきます）	partOfSpeech:［动1］	expl:发觉，发现
pronun:きにいります	writing:（気に入ります）	partOfSpeech:null	expl:喜欢，中意
pronun:きねんひん	writing:（記念品）	partOfSpeech:〔名〕	expl:纪念品
pronun:きのう	writing:（昨日）	partOfSpeech:〔名〕	expl:昨天
pronun:きのした	writing:（木下）	partOfSpeech:［专］	expl:木下
pronun:きびしい	writing:（厳しい）	partOfSpeech:［形1］	expl:严厉，严格
pronun:きぶん	writing:（気分）	partOfSpeech:［名］	expl:情绪；（身体）舒适（与否）
pronun:きぼ	writing:（規模）	partOfSpeech:［名］	expl:规模
pronun:きます	writing:（来ます）	partOfSpeech:〔动3〕	expl:来
pronun:きます	writing:（着ます）	partOfSpeech:〔动2〕	expl:穿
pronun:きまります	writing:（決まります）	partOfSpeech:〔动1〕	expl:定，决定
pronun:きむら	writing:（木村）	partOfSpeech:［专］	expl:木村
pronun:きめます	writing:（決めます）	partOfSpeech:〔动2〕	expl:决定
pronun:きもちがいい	writing:（気持ちがいい）	partOfSpeech:null	expl:感觉舒服，心情愉快
pronun:きもちわるい	writing:（気持ち悪い）	partOfSpeech:null	expl:不舒服
pronun:きもち	writing:（気持ち）	partOfSpeech:〔名〕	expl:心情
pronun:きもの	writing:（着物）	partOfSpeech:［名］	expl:和服，衣服
pronun:きゅうけいします	writing:（休憩～）	partOfSpeech:［动3］	expl:休息
pronun:きゅうけいじかん	writing:（休憩時間）	partOfSpeech:〔名〕	expl:休息时间
pronun:きゅうしょくします	writing:（休職～）	partOfSpeech:［动3］	expl:（暂时）停职
pronun:きゅうじつ	writing:（休日）	partOfSpeech:［名］	expl:休息日，假日
pronun:きゅうそく	writing:（急速）	partOfSpeech:［形2］	expl:迅速，快速
pronun:きゅうに	writing:（急に）	partOfSpeech:［副］	expl:突然
pronun:きゅうりょう	writing:（給料）	partOfSpeech:[名]	expl:工资
pronun:きゅう	writing:（急）	partOfSpeech:〔形2〕	expl:突然；紧急
pronun:きょうげき	writing:（京劇）	partOfSpeech:〔名〕	expl:京剧
pronun:きょうしつ	writing:（教室）	partOfSpeech:〔名〕	expl:教室
pronun:きょうし	writing:（教師）	partOfSpeech:［名］	expl:教师
pronun:きょうじゅ	writing:（教授）	partOfSpeech:〔名〕	expl:教授
pronun:きょうだい	writing:（兄弟）	partOfSpeech:〔名〕	expl:兄弟姐妹
pronun:きょうとホテル	writing:（京都～）	partOfSpeech:［专］	expl:京都宾馆
pronun:きょうと	writing:（京都）	partOfSpeech:〔专〕	expl:京都
pronun:きょうみ	writing:（興味）	partOfSpeech:〔名〕	expl:兴趣
pronun:きょう	writing:（今日）	partOfSpeech:〔名〕	expl:今天
pronun:きょく	writing:（曲）	partOfSpeech:［名］	expl:乐曲，歌曲
pronun:きょねん	writing:（去年）	partOfSpeech:〔名〕	expl:去年
pronun:きらい	writing:（嫌い）	partOfSpeech:〔形2〕	expl:讨厌
pronun:きります	writing:（切ります）	partOfSpeech:〔动1〕	expl:剪，切，割
pronun:きり	writing:（霧）	partOfSpeech:［名］	expl:雾
pronun:きれい	writing:null	partOfSpeech:〔形2〕	expl:漂亮，干净
pronun:きをつけます	writing:（気をつけます）	partOfSpeech:null	expl:注意
pronun:きんえん	writing:（禁煙）	partOfSpeech:〔名〕	expl:禁止吸烟
pronun:きんじょ	writing:（近所）	partOfSpeech:［名］	expl:附近
pronun:きんだいか	writing:（近代化）	partOfSpeech:［名］	expl:现代化
pronun:きんちょうします	writing:（緊張～）	partOfSpeech:［动3］	expl:紧张
pronun:きんようび	writing:（金曜日）	partOfSpeech:〔名〕	expl:星期五
pronun:き	writing:（樹）	partOfSpeech:〔名〕	expl:树，树木
pronun:き	writing:（気）	partOfSpeech:〔名〕	expl:精神，意识
pronun:ぎゅうにく	writing:（牛肉）	partOfSpeech:［名］	expl:牛肉
pronun:ぎゅうにゅう	writing:（牛乳）	partOfSpeech:［名］	expl:牛奶
pronun:ぎょうれつ	writing:（行列）	partOfSpeech:［名］	expl:行列，队伍
pronun:ぎんこう	writing:（銀行）	partOfSpeech:〔名〕	expl:银行
pronun:ぎんざ	writing:（銀座）	partOfSpeech:〔专〕	expl:银座
pronun:くうき	writing:（空気）	partOfSpeech:〔名〕	expl:空气
pronun:くうこう	writing:（空港）	partOfSpeech:[名]	expl:机场
pronun:くうふく	writing:（空腹）	partOfSpeech:［名］	expl:空肚子，空腹，饿
pronun:くさります	writing:（腐ります）	partOfSpeech:［动1］	expl:腐烂，腐败
pronun:くすり	writing:（薬）	partOfSpeech:〔名〕	expl:药
pronun:ください	writing:null	partOfSpeech:null	expl:给我
pronun:くださいます	writing:null	partOfSpeech:［动1］	expl:（尊他）给
pronun:くだもの	writing:（果物）	partOfSpeech:〔名〕	expl:水果
pronun:くつ	writing:（靴）	partOfSpeech:〔名〕	expl:鞋
pronun:くに	writing:（国）	partOfSpeech:〔名〕	expl:国，国家
pronun:くねくね	writing:null	partOfSpeech:［副］	expl:弯曲，弯弯曲曲
pronun:くもります	writing:（曇ります）	partOfSpeech:［动1］	expl:天阴
pronun:くもり	writing:（曇り）	partOfSpeech:〔名〕	expl:阴天
pronun:くらい	writing:（暗い）	partOfSpeech:〔形1〕	expl:黑暗，昏暗
pronun:くらします	writing:（暮らします）	partOfSpeech:［动1］	expl:生活
pronun:くりかえします	writing:（繰り返します）	partOfSpeech:［动1］	expl:反复
pronun:くるま	writing:（車）	partOfSpeech:〔名〕	expl:车
pronun:くれます	writing:null	partOfSpeech:［动2］	expl:给
pronun:くろい	writing:（黒い）	partOfSpeech:〔形1〕	expl:黑，黑色
pronun:くろうします	writing:（苦労～）	partOfSpeech:［动3］	expl:辛苦，辛劳
pronun:くわしい	writing:（詳しい）	partOfSpeech:［形1］	expl:详细
pronun:ぐあい	writing:（具合）	partOfSpeech:［名］	expl:情况
pronun:ぐたいてき	writing:（具体的）	partOfSpeech:［形2］	expl:具体
pronun:ぐっと	writing:null	partOfSpeech:［副］	expl:更加；用力
pronun:けいかく	writing:（計画）	partOfSpeech:［名］	expl:计划
pronun:けいかん	writing:（警官）	partOfSpeech:［名］	expl:警察
pronun:けいけんします	writing:（経験～）	partOfSpeech:［动3］	expl:经验，经历
pronun:けいさつかん	writing:（警察官）	partOfSpeech:［名］	expl:警察
pronun:けいさん	writing:（計算）	partOfSpeech:［名］	expl:计算
pronun:けいざい	writing:（経済）	partOfSpeech:［名］	expl:经济
pronun:けいたいでんわ	writing:（携帯電話）	partOfSpeech:〔名〕	expl:手机
pronun:けいたい	writing:（携帯）	partOfSpeech:〔名〕	expl:手机
pronun:けいび	writing:（警備）	partOfSpeech:〔名〕	expl:戒备，警备
pronun:けが	writing:null	partOfSpeech:[名]	expl:伤
pronun:けがわ	writing:（毛皮）	partOfSpeech:［名］	expl:毛皮
pronun:けさ	writing:（今朝）	partOfSpeech:〔名〕	expl:今天早晨
pronun:けします	writing:（消します）	partOfSpeech:〔动1〕	expl:关（灯），消除，去除
pronun:けしゴム	writing:（消し～）	partOfSpeech:［名］	expl:橡皮
pronun:けっこうです	writing:（結構です）	partOfSpeech:null	expl:不用，不要
pronun:けっこう	writing:null	partOfSpeech:［副］	expl:很，相当
pronun:けっこんしき	writing:（結婚式）	partOfSpeech:〔名〕	expl:结婚典礼
pronun:けっこんします	writing:（結婚～）	partOfSpeech:〔动3〕	expl:结婚
pronun:けっせきします	writing:（欠席～）	partOfSpeech:［动3］	expl:缺席
pronun:けんかします	writing:null	partOfSpeech:［动3］	expl:吵架，打架
pronun:けんきゅうします	writing:（研究～）	partOfSpeech:〔动3〕	expl:研究
pronun:けんこう	writing:（健康）	partOfSpeech:〔名〕	expl:健康
pronun:けんしゅうせい	writing:（研修生）	partOfSpeech:〔名〕	expl:进修生
pronun:けんしゅう	writing:（研修）	partOfSpeech:〔名〕	expl:进修
pronun:けんちくか	writing:（建築家）	partOfSpeech:〔名〕	expl:建筑师
pronun:けんとうします	writing:（検討～）	partOfSpeech:［动3］	expl:讨论
pronun:けん	writing:（件）	partOfSpeech:〔名〕	expl:事件，事情
pronun:けん	writing:（券）	partOfSpeech:［名］	expl:券，票
pronun:げきじょう	writing:（劇場）	partOfSpeech:［名］	expl:剧场，剧院
pronun:げつようび	writing:（月曜日）	partOfSpeech:〔名〕	expl:星期一
pronun:げんかん	writing:（玄関）	partOfSpeech:［名］	expl:门口，玄关
pronun:げんき	writing:（元気）	partOfSpeech:〔形2〕	expl:健康，有精神
pronun:げんこう	writing:（原稿）	partOfSpeech:〔名〕	expl:稿子，原稿
pronun:げんじゅう	writing:（厳重）	partOfSpeech:〔形2〕	expl:森严；严格
pronun:げんだいじん	writing:（現代人）	partOfSpeech:［名］	expl:现代人
pronun:こいぬ	writing:（子犬）	partOfSpeech:［名］	expl:小狗
pronun:こいびと	writing:（恋人）	partOfSpeech:〔名〕	expl:恋人
pronun:こい	writing:（濃い）	partOfSpeech:〔形1〕	expl:（口味）重；浓
pronun:こう	writing:null	partOfSpeech:〔副〕	expl:这样，如此
pronun:こうえん	writing:（公園）	partOfSpeech:〔名〕	expl:公园
pronun:こうかんします	writing:（交換～）	partOfSpeech:［动3］	expl:换，交换
pronun:こうきゅう	writing:（高級）	partOfSpeech:〔名〕	expl:高级
pronun:こうくうがいしゃ	writing:（航空会社）	partOfSpeech:〔名〕	expl:航空公司
pronun:こうくうびん	writing:（航空便）	partOfSpeech:〔名〕	expl:航空邮件
pronun:こうこう	writing:（高校）	partOfSpeech:［名］	expl:高中　
pronun:こうこく	writing:（広告）	partOfSpeech:〔名〕	expl:广告
pronun:こうさてん	writing:（交差点）	partOfSpeech:〔名〕	expl:十字路口
pronun:こうざん	writing:（香山）	partOfSpeech:［专］	expl:香山
pronun:こうじょう	writing:（工場）	partOfSpeech:［名］	expl:工厂
pronun:こうすい	writing:（香水）	partOfSpeech:［名］	expl:香水
pronun:こうそくどうろ	writing:（高速道路）	partOfSpeech:[名]	expl:高速公路
pronun:こうそくバス	writing:（高速～）	partOfSpeech:［名］	expl:高速公共汽车
pronun:こうちゃ	writing:（紅茶）	partOfSpeech:〔名〕	expl:红茶
pronun:こうちょう	writing:（好調）	partOfSpeech:［形2］	expl:顺利，情况良好
pronun:こうつうきかん	writing:（交通機関）	partOfSpeech:〔名〕	expl:交通工具
pronun:こうつうじこ	writing:（交通事故）	partOfSpeech:［名］	expl:交通事故
pronun:こうつうじじょう	writing:（交通事情）	partOfSpeech:［名］	expl:交通状况
pronun:こうつうりょう	writing:（交通量）	partOfSpeech:[名]	expl:交通流量，通行量
pronun:こうつう	writing:（交通）	partOfSpeech:［名］	expl:交通
pronun:こうどう	writing:（講堂）	partOfSpeech:［名］	expl:讲堂
pronun:こうひょう	writing:（好評）	partOfSpeech:［形2］	expl:好评，称赞
pronun:こうべ	writing:（神戸）	partOfSpeech:〔专〕	expl:神户
pronun:こうほち	writing:（候補地）	partOfSpeech:［名］	expl:候选地
pronun:こうらくち	writing:（行楽地）	partOfSpeech:［名］	expl:景点，浏览地
pronun:こうれいしゃ	writing:（高齢者）	partOfSpeech:［名］	expl:高龄者
pronun:こう	writing:（黄）	partOfSpeech:［专］	expl:黄
pronun:こえます	writing:（超えます）	partOfSpeech:［动2］	expl:超过
pronun:こえ	writing:（声）	partOfSpeech:〔名〕	expl:声音
pronun:こきゅう	writing:（故宮）	partOfSpeech:〔专〕	expl:故宫
pronun:こきゅう	writing:（胡弓）	partOfSpeech:〔名〕	expl:胡琴
pronun:こきょう	writing:（故郷）	partOfSpeech:〔名〕	expl:故乡
pronun:こくさいかいぎ	writing:（国際会議）	partOfSpeech:［名］	expl:国际会议
pronun:こくさいかんけいがく	writing:（国際関係学）	partOfSpeech:［名］	expl:国际关系学
pronun:こくさいぼうえきセンター	writing:（国際貿易センター）	partOfSpeech:null	expl:／国际贸易中心
pronun:こくぼう	writing:（国貿）	partOfSpeech:［专］	expl:国贸
pronun:ここ	writing:null	partOfSpeech:〔代〕	expl:这里，这儿
pronun:こころ	writing:（心）	partOfSpeech:［名］	expl:心
pronun:こさじ	writing:（小さじ）	partOfSpeech:［名］	expl:小匙，小勺
pronun:こしょうします	writing:（故障～）	partOfSpeech:［动3］	expl:故障
pronun:こたえます	writing:（答えます）	partOfSpeech:［动2］	expl:回答
pronun:こちら	writing:null	partOfSpeech:〔代〕	expl:这儿，这边
pronun:こちらこそ	writing:null	partOfSpeech:null	expl:我才要（请您～）
pronun:こっそり	writing:null	partOfSpeech:［副］	expl:偷偷地，悄悄地
pronun:ことば	writing:（言葉）	partOfSpeech:〔名〕	expl:语言
pronun:ことり	writing:（小鳥）	partOfSpeech:［名］	expl:小鸟，鸟儿
pronun:こと	writing:null	partOfSpeech:［名］	expl:事情
pronun:こどものひ	writing:（こどもの日）	partOfSpeech:〔名〕	expl:儿童节
pronun:こども	writing:（子供）	partOfSpeech:〔名〕	expl:孩子，小孩
pronun:この	writing:null	partOfSpeech:null	expl:〔连体〕 这，这个
pronun:このあたり	writing:null	partOfSpeech:null	expl:这一带，这附近
pronun:このごろ	writing:null	partOfSpeech:null	expl:最近，近来，最近时期
pronun:このたび	writing:（この度）	partOfSpeech:［名］	expl:这次，这回
pronun:このへん	writing:（この辺）	partOfSpeech:null	expl:这一带，这附近，这儿
pronun:このまえ	writing:（この前）	partOfSpeech:null	expl:前几天，之前，最近
pronun:このまま	writing:null	partOfSpeech:null	expl:就这样，照这样，如此
pronun:こまります	writing:（困ります）	partOfSpeech:［动1］	expl:为难，难办
pronun:こみます	writing:（込みます）	partOfSpeech:〔动1〕	expl:拥挤，混杂
pronun:こむぎこ	writing:（小麦粉）	partOfSpeech:〔名〕	expl:面粉
pronun:こもの	writing:（小物）	partOfSpeech:［名］	expl:小东西，细小的附件
pronun:これ	writing:null	partOfSpeech:〔代〕	expl:这，这个
pronun:これから	writing:null	partOfSpeech:〔副〕	expl:从现在起，今后
pronun:これとも	writing:null	partOfSpeech:〔连〕	expl:还是，或者
pronun:ころびます	writing:（転びます）	partOfSpeech:〔动1〕	expl:摔，摔倒，跌倒
pronun:こわい	writing:（怖い）	partOfSpeech:〔形1〕	expl:害怕，恐怖
pronun:こわします	writing:（壊します）	partOfSpeech:［动1］	expl:弄坏
pronun:こわれます	writing:（壊れます）	partOfSpeech:［动2］	expl:出故障，坏
pronun:こんかい	writing:（今回）	partOfSpeech:［名］	expl:这次，这回
pronun:こんげつ	writing:（今月）	partOfSpeech:［名］	expl:这个月
pronun:こんご	writing:（今後）	partOfSpeech:［名］	expl:今后
pronun:こんしゅう	writing:（今週）	partOfSpeech:〔名〕	expl:这个星期
pronun:こんど	writing:（今度）	partOfSpeech:〔副〕	expl:下次；这回
pronun:こんなに	writing:null	partOfSpeech:［副］	expl:这么，这样地
pronun:こんにちは	writing:null	partOfSpeech:null	expl:你好
pronun:こんばん	writing:（今晩）	partOfSpeech:〔名〕	expl:今天晚上
pronun:こんや	writing:（今夜）	partOfSpeech:[名]	expl:今天晚上
pronun:こ	writing:（子）	partOfSpeech:〔名〕	expl:孩子
pronun:ごうかくします	writing:（合格～）	partOfSpeech:［动3］	expl:及格，合格
pronun:ごうか	writing:（豪華）	partOfSpeech:［形2］	expl:豪华，奢华
pronun:ごうべんがいしゃ	writing:（合弁会社）	partOfSpeech:［名］	expl:合资公司
pronun:ごご	writing:（午後）	partOfSpeech:null	expl:null
pronun:ございます	writing:null	partOfSpeech:［动1］	expl:在，有，是
pronun:ごしゅじん	writing:（ご主人）	partOfSpeech:［名］	expl:您丈夫，您先生
pronun:ごぜんちゅう	writing:（午前中）	partOfSpeech:null	expl:上午
pronun:ごぜん	writing:（午前）	partOfSpeech:null	expl:null
pronun:ごぞんじです	writing:（ご存じです）	partOfSpeech:null	expl:（尊他）知道
pronun:ごちそうします	writing:null	partOfSpeech:〔动3〕	expl:请客，摆盛宴
pronun:ごはん	writing:（ご飯）	partOfSpeech:［名］	expl:饭
pronun:ごみ	writing:null	partOfSpeech:〔名〕	expl:垃圾
pronun:ごみばこ	writing:（ごみ箱）	partOfSpeech:［名］	expl:垃圾箱
pronun:ごめん	writing:null	partOfSpeech:〔叹〕	expl:抱歉，请原谅
pronun:ごらんになります	writing:（ご覧になります）	partOfSpeech:［动1］	expl:（尊他）看，读
pronun:ごろ	writing:null	partOfSpeech:null	expl:null
pronun:ご	writing:null	partOfSpeech:null	expl:～
pronun:さあ	writing:null	partOfSpeech:〔叹〕	expl:啊，喂
pronun:さいかい	writing:（再会）	partOfSpeech:［名］	expl:重逢，再会
pronun:さいきん	writing:（最近）	partOfSpeech:〔名〕	expl:最近，近来
pronun:さいこう	writing:(最高)	partOfSpeech:[形2]	expl:最好，最高
pronun:さいご	writing:（最後）	partOfSpeech:［名］	expl:最后
pronun:さいしゅうてんけん	writing:（最終点検）	partOfSpeech:［名］	expl:最终检查
pronun:さいしゅうびん	writing:（最終便）	partOfSpeech:［名］	expl:最晚航班
pronun:さいしゅう	writing:（最終）	partOfSpeech:［名］	expl:最终
pronun:さいしょ	writing:（最初）	partOfSpeech:［名］	expl:开始的时候，最初
pronun:さいしん	writing:（最新）	partOfSpeech:〔名〕	expl:最新
pronun:さいふ	writing:（財布）	partOfSpeech:〔名〕	expl:钱包
pronun:さかな	writing:（魚）	partOfSpeech:〔名〕	expl:鱼
pronun:さがします	writing:（探します）	partOfSpeech:〔动1〕	expl:找，寻找，寻求
pronun:さがります	writing:（下がります）	partOfSpeech:［动1］	expl:下降，降低
pronun:さきに	writing:（先に）	partOfSpeech:〔副〕	expl:先
pronun:さきほど	writing:（先ほど）	partOfSpeech:［副］	expl:刚才，方才
pronun:さきます	writing:（咲きます）	partOfSpeech:〔动1〕	expl:花开
pronun:さくじつ	writing:（昨日）	partOfSpeech:［名］	expl:昨天
pronun:さくねん	writing:（昨年）	partOfSpeech:［名］	expl:去年
pronun:さくひん	writing:（作品）	partOfSpeech:〔名〕	expl:作品
pronun:さくら	writing:（桜）	partOfSpeech:［名］	expl:樱花
pronun:さけます	writing:（避けます）	partOfSpeech:［动2］	expl:回避，避免
pronun:さげます	writing:（下げます）	partOfSpeech:［动2］	expl:降低，下降
pronun:ささき	writing:（佐々木）	partOfSpeech:［专］	expl:佐佐木
pronun:さしあげます	writing:（差し上げます）	partOfSpeech:［动2］	expl:（自谦）给
pronun:さしみ	writing:（刺身）	partOfSpeech:［名］	expl:生鲜鱼，贝片
pronun:さすが	writing:null	partOfSpeech:［副］	expl:不愧是，果然
pronun:さそいます	writing:（誘います）	partOfSpeech:［动1］	expl:邀请，约请
pronun:さっか	writing:（作家）	partOfSpeech:〔名〕	expl:作家
pronun:さっき	writing:null	partOfSpeech:〔副〕	expl:刚才
pronun:さっそく	writing:（早速）	partOfSpeech:［副］	expl:马上，立即
pronun:さつえいきんし	writing:（撮影禁止）	partOfSpeech:〔名〕	expl:禁止拍照
pronun:さとう	writing:（佐藤）	partOfSpeech:〔专〕	expl:佐藤
pronun:さとう	writing:（砂糖）	partOfSpeech:［名］	expl:砂糖
pronun:さびしい	writing:（寂しい）	partOfSpeech:［形1］	expl:寂寞
pronun:さむい	writing:（寒い）	partOfSpeech:〔形1〕	expl:寒冷
pronun:さむけ	writing:（寒気）	partOfSpeech:［名］	expl:寒气，寒战
pronun:さようなら	writing:null	partOfSpeech:null	expl:再见
pronun:さらいしゅう	writing:（さ来週）	partOfSpeech:〔名〕	expl:下下个星期
pronun:さらに	writing:null	partOfSpeech:〔副〕	expl:更加，更
pronun:さわぎます	writing:（騒ぎます）	partOfSpeech:［动1］	expl:吵嚷，吵闹
pronun:さわやか	writing:null	partOfSpeech:［形2］	expl:清爽，爽快
pronun:さわります	writing:（触ります）	partOfSpeech:〔动1〕	expl:碰，触
pronun:さんかします	writing:（参加～）	partOfSpeech:［动3］	expl:参加
pronun:さんかんろ	writing:（三環路）	partOfSpeech:［专］	expl:三环路
pronun:さんぽします	writing:（散歩～）	partOfSpeech:〔动3〕	expl:散步
pronun:さんわりびき	writing:（３割引）	partOfSpeech:〔名〕	expl:七折
pronun:ざいこ	writing:（在庫）	partOfSpeech:［名］	expl:库存，存货
pronun:ざっし	writing:（雑誌）	partOfSpeech:〔名〕	expl:杂志
pronun:ざんぎょうします	writing:（残業～）	partOfSpeech:〔动2〕	expl:加班
pronun:ざんしん	writing:（斬新）	partOfSpeech:［形2］	expl:新颖，崭新
pronun:ざんねん	writing:（残念）	partOfSpeech:［形2］	expl:可惜，遗憾
pronun:しあい	writing:（試合）	partOfSpeech:［名］	expl:比赛，竞赛
pronun:しおからい	writing:（塩辛い）	partOfSpeech:null	expl:null
pronun:しお	writing:（塩）	partOfSpeech:［名］	expl:盐，食盐
pronun:しかし	writing:null	partOfSpeech:［连］	expl:可是，但是
pronun:しかたない	writing:（仕方ない）	partOfSpeech:null	expl:没有办法
pronun:しかも	writing:null	partOfSpeech:［连］	expl:而且
pronun:しかります	writing:null	partOfSpeech:［动1］	expl:训，责备，斥责
pronun:しがい	writing:（市街）	partOfSpeech:[名]	expl:市内，市街，繁华街道
pronun:しきんじょう	writing:（紫禁城）	partOfSpeech:［专］	expl:紫禁城
pronun:しけん	writing:（試験）	partOfSpeech:〔名〕	expl:考试
pronun:しげん	writing:（資源）	partOfSpeech:［名］	expl:资源
pronun:しごと	writing:（仕事）	partOfSpeech:〔名〕	expl:工作
pronun:しさくします	writing:（試作～）	partOfSpeech:［动3］	expl:试作，试制
pronun:しさつだん	writing:(視察団)	partOfSpeech:［名］	expl:视察团
pronun:ししまい	writing:（獅子舞）	partOfSpeech:〔名〕	expl:狮子舞
pronun:ししゃかい	writing:（試写会）	partOfSpeech:［名］	expl:试映会，预映会
pronun:ししゃちょう	writing:（支社長）	partOfSpeech:［名］	expl:分公司经理
pronun:しじょうちょうさ	writing:（市場調査）	partOfSpeech:［名］	expl:市场调查
pronun:しじょう	writing:（市場）	partOfSpeech:［名］	expl:市场
pronun:しずか	writing:（静か）	partOfSpeech:〔形2〕	expl:安静
pronun:しせんりょうり	writing:（四川料理）	partOfSpeech:〔名〕	expl:四川菜
pronun:しぜん	writing:（自然）	partOfSpeech:[名]	expl:大自然
pronun:したしい	writing:（親しい）	partOfSpeech:［形1］	expl:熟悉，亲切，亲密
pronun:したみ	writing:（下見）	partOfSpeech:［名］	expl:视察
pronun:した	writing:（下）	partOfSpeech:〔名〕	expl:下面
pronun:しっかり	writing:null	partOfSpeech:［副］	expl:充分，充足
pronun:しっぱいします	writing:（失敗～）	partOfSpeech:［动3］	expl:出岔子，失败
pronun:しつもん	writing:（質問）	partOfSpeech:［名］	expl:提问，问题
pronun:しつれいしました	writing:（失礼しました）	partOfSpeech:null	expl:打搅了，失礼了
pronun:しつれいします	writing:（失礼します）	partOfSpeech:null	expl:告辞了，我走了
pronun:しつれい	writing:（失礼）	partOfSpeech:［形2］	expl:不礼貌
pronun:してん	writing:（支店）	partOfSpeech:［名］	expl:分店，分公司
pronun:しどう	writing:（指導）	partOfSpeech:［名］	expl:指教，指导
pronun:しない	writing:（市内）	partOfSpeech:［名］	expl:市内
pronun:しなもの	writing:（品物）	partOfSpeech:〔名〕	expl:物品，商品
pronun:しにます	writing:（死にます）	partOfSpeech:〔动1〕	expl:死，死亡
pronun:しばらくです	writing:null	partOfSpeech:null	expl:好久不见
pronun:しばらく	writing:null	partOfSpeech:［副］	expl:许久，好久；片刻
pronun:しぶや	writing:（渋谷）	partOfSpeech:〔专〕	expl:涩谷
pronun:しまいます	writing:null	partOfSpeech:［动1］	expl:收拾起来，放到～里边
pronun:します	writing:null	partOfSpeech:〔动3〕	expl:干，做
pronun:しまります	writing:（閉まります）	partOfSpeech:［动1］	expl:关闭，关
pronun:しみず	writing:（清水）	partOfSpeech:〔专〕	expl:清水
pronun:しめます	writing:（閉めます）	partOfSpeech:〔动2〕	expl:关闭，关门
pronun:しゃいんりょこう	writing:（社員旅行）	partOfSpeech:［名］	expl:全社旅行
pronun:しゃいん	writing:（社員）	partOfSpeech:〔名〕	expl:职员
pronun:しゃかいじん	writing:（社会人）	partOfSpeech:〔名〕	expl:社会的一员，成人
pronun:しゃこうダンス	writing:（社交～）	partOfSpeech:［名］	expl:交际舞
pronun:しゃしんしゅう	writing:（写真集）	partOfSpeech:〔名〕	expl:影集
pronun:しゃしんてん	writing:（写真展）	partOfSpeech:〔名〕	expl:摄影展
pronun:しゃしん	writing:（写真）	partOfSpeech:〔名〕	expl:照片
pronun:しゃちょう	writing:（社長）	partOfSpeech:〔名〕	expl:总经理，社长
pronun:しゃれます	writing:null	partOfSpeech:［动2］	expl:别致，风趣；打扮得漂亮
pronun:しゃ	writing:（社）	partOfSpeech:［名］	expl:公司
pronun:しやくしょ	writing:（市役所）	partOfSpeech:〔名〕	expl:市政府
pronun:しゅうおんらい	writing:（周恩来）	partOfSpeech:［专］	expl:周恩来
pronun:しゅうかん	writing:（習慣）	partOfSpeech:［名］	expl:习惯
pronun:しゅうがくりょこう	writing:（修学旅行）	partOfSpeech:〔名〕	expl:修学旅行
pronun:しゅうしょく	writing:（就職）	partOfSpeech:［名］	expl:就业
pronun:しゅうでん	writing:（終電）	partOfSpeech:［名］	expl:末班电车
pronun:しゅうへん	writing:（周辺）	partOfSpeech:〔名〕	expl:附近，周边
pronun:しゅうまつ	writing:（週末）	partOfSpeech:〔名〕	expl:周末
pronun:しゅうり	writing:（修理）	partOfSpeech:〔名〕	expl:修理
pronun:しゅう	writing:（周）	partOfSpeech:［专］	expl:周
pronun:しゅくだい	writing:（宿題）	partOfSpeech:〔名〕	expl:作业
pronun:しゅしょう	writing:（首相）	partOfSpeech:［名］	expl:首相
pronun:しゅっか	writing:（出荷）	partOfSpeech:［名］	expl:上市，运出货物
pronun:しゅっきんします	writing:（出勤～）	partOfSpeech:［动3］	expl:上班，出勤
pronun:しゅっしん	writing:（出身）	partOfSpeech:［名］	expl:出生地
pronun:しゅっせきします	writing:（出席～）	partOfSpeech:［动3］	expl:出席
pronun:しゅっちょう	writing:（出張）	partOfSpeech:〔名〕	expl:出差
pronun:しゅっぱつします	writing:（出発～）	partOfSpeech:［动3］	expl:出发
pronun:しゅっぱつじこく	writing:（出発時刻）	partOfSpeech:［名］	expl:出发时间
pronun:しゅつじょうします	writing:（出場～）	partOfSpeech:［动3］	expl:参加，出场
pronun:しゅみ	writing:（趣味）	partOfSpeech:〔名〕	expl:爱好
pronun:しゅるい	writing:（種類）	partOfSpeech:〔名〕	expl:种类
pronun:しゅんせつ	writing:（春節）	partOfSpeech:〔名〕	expl:春节
pronun:しょうかいします	writing:（紹介～）	partOfSpeech:［动3］	expl:介绍
pronun:しょうがくせい	writing:（小学生）	partOfSpeech:［名］	expl:小学生
pronun:しょうがっこう	writing:（小学校）	partOfSpeech:［名］	expl:小学
pronun:しょうがつやすみ	writing:（正月休み）	partOfSpeech:［名］	expl:新年假日
pronun:しょうしか	writing:（少子化）	partOfSpeech:［名］	expl:孩子减少现象
pronun:しょうしょう	writing:（少々）	partOfSpeech:［副］	expl:稍稍，一点儿
pronun:しょうせつ	writing:（小説）	partOfSpeech:〔名〕	expl:小说
pronun:しょうたいけん	writing:（招待券）	partOfSpeech:［名］	expl:招待券，请帖
pronun:しょうちします	writing:（承知～）	partOfSpeech:［动3］	expl:知道
pronun:しょうちゅう	writing:（焼酎）	partOfSpeech:〔名〕	expl:烧酒
pronun:しょうひしゃ	writing:（消費者）	partOfSpeech:［名］	expl:消费者
pronun:しょうひん	writing:（商品）	partOfSpeech:［名］	expl:商品
pronun:しょうらい	writing:（将来）	partOfSpeech:〔名〕	expl:将来
pronun:しょう	writing:（賞）	partOfSpeech:［名］	expl:奖
pronun:しょくじします	writing:（食事～）	partOfSpeech:〔动3〕	expl:吃饭，用餐
pronun:しょくどう	writing:（食堂）	partOfSpeech:〔名〕	expl:食堂
pronun:しょしんしゃ	writing:（初心者）	partOfSpeech:〔名〕	expl:初学者
pronun:しょっぱい	writing:null	partOfSpeech:〔形1〕	expl:咸
pronun:しょどう	writing:（書道）	partOfSpeech:〔名〕	expl:书法
pronun:しょるい	writing:（書類）	partOfSpeech:〔名〕	expl:文件，文稿
pronun:しらせます	writing:（知らせます）	partOfSpeech:〔动2〕	expl:告诉
pronun:しらべます	writing:（調べます）	partOfSpeech:〔动2〕	expl:调查
pronun:しります	writing:（知ります）	partOfSpeech:〔动1〕	expl:认识，知道，了解
pronun:しりょう	writing:（資料）	partOfSpeech:〔名〕	expl:资料
pronun:しろい	writing:（白い）	partOfSpeech:〔形1〕	expl:白色的
pronun:しんかんせん	writing:（新幹線）	partOfSpeech:〔名〕	expl:新干线
pronun:しんがた	writing:（新型）	partOfSpeech:［名］	expl:新型
pronun:しんきょ	writing:（新居）	partOfSpeech:［名］	expl:新居
pronun:しんきんかん	writing:（親近感）	partOfSpeech:［名］	expl:亲切感
pronun:しんごう	writing:（信号）	partOfSpeech:［名］	expl:信号，红绿灯
pronun:しんしゃ	writing:（新車）	partOfSpeech:［名］	expl:新车
pronun:しんしゅんセール	writing:（新春～）	partOfSpeech:〔名〕	expl:新年大甩卖
pronun:しんじます	writing:（信じます）	partOfSpeech:［动2］	expl:相信，信任
pronun:しんじゅく	writing:（新宿）	partOfSpeech:〔专〕	expl:新宿
pronun:しんせい	writing:（申請）	partOfSpeech:［名］	expl:申请
pronun:しんせつ	writing:（親切）	partOfSpeech:〔形2〕	expl:热情
pronun:しんせん	writing:（新鮮）	partOfSpeech:［形2］	expl:新鲜
pronun:しんにゅうしゃいん	writing:（新入社員）	partOfSpeech:［名］	expl:新来的职员
pronun:しんぱいします	writing:（心配～）	partOfSpeech:〔动3〕	expl:担心
pronun:しんぶんし	writing:（新聞紙）	partOfSpeech:〔名〕	expl:报纸
pronun:しんぶん	writing:（新聞）	partOfSpeech:〔名〕	expl:报纸
pronun:しんりん	writing:（森林）	partOfSpeech:［名］	expl:森林
pronun:しん	writing:（清）	partOfSpeech:［专］	expl:清，清代
pronun:し	writing:（詩）	partOfSpeech:［名］	expl:诗歌
pronun:じかい	writing:（次回）	partOfSpeech:［名］	expl:下次，下回
pronun:じかんたい	writing:（時間帯）	partOfSpeech:［名］	expl:时间段
pronun:じかん	writing:（時間）	partOfSpeech:〔名〕	expl:时间
pronun:じこ	writing:(事故)	partOfSpeech:［名］	expl:事故
pronun:じしょくします	writing:（辞職～）	partOfSpeech:［动3］	expl:辞职
pronun:じしょ	writing:（辞書）	partOfSpeech:〔名〕	expl:词典
pronun:じしん	writing:（地震）	partOfSpeech:〔名〕	expl:地震
pronun:じだい	writing:（時代）	partOfSpeech:［名］	expl:时代
pronun:じっかんします	writing:（実感～）	partOfSpeech:［动3］	expl:切实感受，真切感受
pronun:じっさいに	writing:（実際に）	partOfSpeech:［副］	expl:实地，实际上
pronun:じつげんします	writing:（実現～）	partOfSpeech:［动3］	expl:实现
pronun:じつは	writing:（実は）	partOfSpeech:［副］	expl:其实，实际上
pronun:じてんしゃ	writing:（自転車）	partOfSpeech:〔名〕	expl:自行车
pronun:じどうしゃ	writing:（自動車）	partOfSpeech:〔名〕	expl:汽车
pronun:じぶん	writing:（自分）	partOfSpeech:〔名〕	expl:自己
pronun:じみ	writing:（地味）	partOfSpeech:〔形2〕	expl:朴素，质朴
pronun:じむしょさがし	writing:（事務所探し）	partOfSpeech:null	expl:寻找事务所
pronun:じむしょ	writing:（事務所）	partOfSpeech:〔名〕	expl:事务所，办事处
pronun:じゃあ	writing:null	partOfSpeech:null	expl:null
pronun:じゅうしょ	writing:（住所）	partOfSpeech:〔名〕	expl:住址
pronun:じゅうたいします	writing:（渋滞～）	partOfSpeech:［动3］	expl:堵车，停滞
pronun:じゅうぶん	writing:（十分）	partOfSpeech:〔副〕	expl:好好地，充足地
pronun:じゅうようさ	writing:（重要さ）	partOfSpeech:［名］	expl:重要性，重要程度
pronun:じゅうよう	writing:（重要）	partOfSpeech:［形2］	expl:重要
pronun:じゅぎょう	writing:（授業）	partOfSpeech:〔名〕	expl:授课，上课
pronun:じゅく	writing:（塾）	partOfSpeech:［名］	expl:私塾，补习学校
pronun:じゅんび	writing:（準備）	partOfSpeech:〔名〕	expl:准备
pronun:じゆう	writing:（自由）	partOfSpeech:［形2］	expl:随便，自由
pronun:じょうきゅうしゃ	writing:（上級者）	partOfSpeech:〔名〕	expl:熟练者
pronun:じょうきゅうクラス	writing:（上級～）	partOfSpeech:〔名〕	expl:高级班
pronun:じょうし	writing:（上司）	partOfSpeech:［名］	expl:上司
pronun:じょうず	writing:（上手）	partOfSpeech:〔形2〕	expl:擅长，高明，水平高
pronun:じょうぶ	writing:（丈夫）	partOfSpeech:［形2］	expl:牢固，结实
pronun:じょせいむけ	writing:（女性向け）	partOfSpeech:［名］	expl:女性专用，专为女性
pronun:じょせい	writing:（女性）	partOfSpeech:〔名〕	expl:女性
pronun:じょゆう	writing:（女優）	partOfSpeech:[名]	expl:女演员
pronun:じんこう	writing:（人口）	partOfSpeech:［名］	expl:人口
pronun:じ	writing:（字）	partOfSpeech:［名］	expl:字
pronun:すいえいせんしゅ	writing:（水泳選手）	partOfSpeech:［名］	expl:游泳选手
pronun:すいえい	writing:（水泳）	partOfSpeech:〔名〕	expl:游泳
pronun:すいがら	writing:（吸殻）	partOfSpeech:［名］	expl:烟头，烟灰，烟蒂
pronun:すいとう	writing:（水筒）	partOfSpeech:〔名〕	expl:水壶，水筒
pronun:すいます	writing:（吸います）	partOfSpeech:〔动1〕	expl:吸（烟）
pronun:すいみんをとります	writing:（睡眠をとります）	partOfSpeech:null	expl:睡觉
pronun:すいみん	writing:（睡眠）	partOfSpeech:〔名〕	expl:睡眠
pronun:すいようび	writing:（水曜日）	partOfSpeech:〔名〕	expl:星期三
pronun:すうがく	writing:（数学）	partOfSpeech:[名]	expl:数学
pronun:すえ	writing:（末）	partOfSpeech:［名］	expl:末尾，末了
pronun:すきます	writing:null	partOfSpeech:〔动1〕	expl:（肚子）饿，空
pronun:すきやき	writing:（すき焼き）	partOfSpeech:〔名〕	expl:日式牛肉火锅
pronun:すき	writing:（好き）	partOfSpeech:〔形2〕	expl:喜欢
pronun:すぎます	writing:（過ぎます）	partOfSpeech:〔动2〕	expl:过
pronun:すくない	writing:（少ない）	partOfSpeech:〔形1〕	expl:少
pronun:すぐ	writing:null	partOfSpeech:〔副〕	expl:马上，立即
pronun:すぐに	writing:null	partOfSpeech:［副］	expl:就要，立刻，马上
pronun:すこい	writing:null	partOfSpeech:〔副〕	expl:惊人的，了不起
pronun:すこし	writing:（少し）	partOfSpeech:null	expl:null
pronun:すごします	writing:（過ごします）	partOfSpeech:［动1］	expl:度过；生活
pronun:すし	writing:（寿司）	partOfSpeech:〔名〕	expl:寿司
pronun:すすみます	writing:（進みます）	partOfSpeech:［动1］	expl:加重，前进
pronun:すすめます	writing:（進めます）	partOfSpeech:［动2］	expl:推进，使前进
pronun:すずき	writing:（鈴木）	partOfSpeech:［专］	expl:铃木
pronun:すずしい	writing:（涼しい）	partOfSpeech:〔形1〕	expl:凉爽
pronun:すっぱい	writing:（酸っぱい）	partOfSpeech:〔形1〕	expl:酸
pronun:すてき	writing:null	partOfSpeech:［形2］	expl:漂亮，极好
pronun:すてます	writing:（捨てます）	partOfSpeech:〔动2〕	expl:扔，扔掉
pronun:すばらしい	writing:null	partOfSpeech:〔形1〕	expl:极好，绝佳
pronun:すべて	writing:null	partOfSpeech:［名］	expl:全部，所有
pronun:すべります	writing:（滑ります）	partOfSpeech:〔动1〕	expl:滑，滑行
pronun:すませます	writing:（済ませます）	partOfSpeech:［动2］	expl:搞完，办完
pronun:すみます	writing:（住みます）	partOfSpeech:〔动1〕	expl:住，居住
pronun:すみます	writing:（済みます）	partOfSpeech:［动1］	expl:结束，完了
pronun:すみません	writing:null	partOfSpeech:null	expl:对不起，请问
pronun:すみませんが	writing:null	partOfSpeech:null	expl:对不起……，劳驾……
pronun:すやすや	writing:null	partOfSpeech:［副］	expl:香甜地，安静地
pronun:すり	writing:null	partOfSpeech:［名］	expl:扒手，小偷
pronun:すわります	writing:（座ります）	partOfSpeech:〔动1〕	expl:坐，落座
pronun:ずいぶん	writing:null	partOfSpeech:〔副〕	expl:相当，非常，很
pronun:ずっと	writing:null	partOfSpeech:〔副〕	expl:～得多
pronun:ずっと	writing:null	partOfSpeech:［副］	expl:一直，始终
pronun:ずつう	writing:（頭痛）	partOfSpeech:［名］	expl:头疼
pronun:せいかく	writing:（性格）	partOfSpeech:［名］	expl:性格
pronun:せいかつ	writing:（生活）	partOfSpeech:〔名〕	expl:生活
pronun:せいこうします	writing:（成功～）	partOfSpeech:［动3］	expl:成功
pronun:せいさんします	writing:（生産～）	partOfSpeech:［动3］	expl:生产
pronun:せいさんコスト	writing:（生産～）	partOfSpeech:［名］	expl:生产成本
pronun:せいせき	writing:（成績）	partOfSpeech:［名］	expl:成绩
pronun:せいぞうします	writing:（製造～）	partOfSpeech:［动3］	expl:生产，制造
pronun:せいちょう	writing:（成長）	partOfSpeech:［名］	expl:成长
pronun:せいと	writing:（生徒）	partOfSpeech:〔名〕	expl:学生
pronun:せいひん	writing:（製品）	partOfSpeech:〔名〕	expl:产品
pronun:せいりします	writing:（整理～）	partOfSpeech:〔动3〕	expl:整理
pronun:せいりょういんりょうすい	writing:（清涼飲料水）	partOfSpeech:［名］	expl:清凉饮料
pronun:せかいいさん	writing:（世界遺産）	partOfSpeech:［名］	expl:世界遗产
pronun:せかい	writing:（世界）	partOfSpeech:〔名〕	expl:世界
pronun:せきにんしゃ	writing:（責任者）	partOfSpeech:［名］	expl:负责人
pronun:せき	writing:（席）	partOfSpeech:〔名〕	expl:座位，席位
pronun:せたがや	writing:（世田谷）	partOfSpeech:［专］	expl:世田谷
pronun:せだい	writing:（世代）	partOfSpeech:［名］	expl:世代；一代
pronun:せっかく	writing:null	partOfSpeech:［副］	expl:好（不）容易，特意
pronun:せっけい	writing:（設計）	partOfSpeech:〔名〕	expl:设计
pronun:せっけん	writing:null	partOfSpeech:［名］	expl:肥皂
pronun:せつび	writing:（設備）	partOfSpeech:［名］	expl:设备
pronun:せつめいしょ	writing:（説明書）	partOfSpeech:［名］	expl:说明书
pronun:せつめい	writing:（説明）	partOfSpeech:［名］	expl:说明
pronun:せまい	writing:（狭い）	partOfSpeech:〔形1〕	expl:狭窄
pronun:せわします	writing:（世話～）	partOfSpeech:［动3］	expl:帮助；照顾
pronun:せんげつ	writing:（先月）	partOfSpeech:〔名〕	expl:上个月
pronun:せんしゅう	writing:（先週）	partOfSpeech:〔名〕	expl:上个星期
pronun:せんしゅ	writing:（選手）	partOfSpeech:［名］	expl:运动员，选手
pronun:せんじつ	writing:（先日）	partOfSpeech:［名］	expl:前几天，前些天
pronun:せんせい	writing:（先生）	partOfSpeech:〔名〕	expl:老师
pronun:せんそう	writing:（戦争）	partOfSpeech:［名］	expl:战争
pronun:せんたくき	writing:（洗濯機）	partOfSpeech:〔名〕	expl:洗衣机
pronun:せんたくします	writing:（洗濯～）	partOfSpeech:〔动3〕	expl:洗涤，洗
pronun:せんたくもの	writing:（洗濯物）	partOfSpeech:［名］	expl:洗的衣服
pronun:せんでん	writing:（宣伝）	partOfSpeech:［名］	expl:宣传
pronun:せんぱい	writing:（先輩）	partOfSpeech:〔名〕	expl:前辈
pronun:せんもん	writing:（専門）	partOfSpeech:[名]	expl:专门
pronun:せんれんします	writing:（洗練～）	partOfSpeech:［动3］	expl:精炼，洗练
pronun:せ	writing:（背）	partOfSpeech:〔名〕	expl:个子
pronun:ぜいたく	writing:null	partOfSpeech:［形2］	expl:奢望，奢侈，过分
pronun:ぜったいに	writing:（絶対に）	partOfSpeech:〔副〕	expl:绝对
pronun:ぜったい	writing:（絶対）	partOfSpeech:［副］	expl:绝对，一定
pronun:ぜひ	writing:null	partOfSpeech:〔副〕	expl:一定
pronun:ぜんいん	writing:（全員）	partOfSpeech:〔名〕	expl:全员
pronun:ぜんぜん	writing:（全然）	partOfSpeech:〔副〕	expl:根本（不），全然（不）
pronun:ぜんちょう	writing:（全長）	partOfSpeech:［名］	expl:全长
pronun:ぜんぶ	writing:（全部）	partOfSpeech:［副］	expl:全部
pronun:そう	writing:null	partOfSpeech:null	expl:null
pronun:そういえば	writing:（そう言えば）	partOfSpeech:null	expl:说起来，这么说来
pronun:そうか	writing:null	partOfSpeech:［叹］	expl:是吗
pronun:そうさ	writing:（操作）	partOfSpeech:〔名〕	expl:操作，操纵
pronun:そうじします	writing:（掃除～）	partOfSpeech:〔动3〕	expl:打扫，扫除
pronun:そうそう	writing:null	partOfSpeech:［叹］	expl:是的是的
pronun:そうたいします	writing:（早退～）	partOfSpeech:［动3］	expl:早退
pronun:そうだんします	writing:（そうだん～）	partOfSpeech:［动3］	expl:商谈
pronun:そうてす	writing:null	partOfSpeech:null	expl:是（这样）
pronun:そうべつかい	writing:（送別会）	partOfSpeech:〔名〕	expl:欢送会
pronun:そうりつします	writing:（創立～）	partOfSpeech:［动3］	expl:成立，创立
pronun:そくたつ	writing:（速達）	partOfSpeech:〔名〕	expl:速递，快件
pronun:そこ	writing:null	partOfSpeech:〔代〕	expl:那里，那儿
pronun:そこで	writing:null	partOfSpeech:［连］	expl:因此，于是，所以；那么
pronun:そして	writing:null	partOfSpeech:〔连〕	expl:而且，于是
pronun:そだちます	writing:（育ちます）	partOfSpeech:［动1］	expl:生长，成长
pronun:そちら	writing:null	partOfSpeech:〔代〕	expl:那儿，那边
pronun:そつぎょうしき	writing:（卒業式）	partOfSpeech:〔名〕	expl:毕业典礼
pronun:そつぎょうします	writing:（卒業～）	partOfSpeech:〔动3〕	expl:毕业
pronun:そと	writing:（外）	partOfSpeech:〔名〕	expl:外面
pronun:その	writing:null	partOfSpeech:null	expl:〔连体〕 那，那个
pronun:そば	writing:null	partOfSpeech:〔名〕	expl:荞麦面
pronun:そばや	writing:（そば屋）	partOfSpeech:〔名〕	expl:荞麦面馆
pronun:そば	writing:null	partOfSpeech:［名］	expl:旁边
pronun:そぼ	writing:（祖母）	partOfSpeech:［名］	expl:祖母，外婆
pronun:そら	writing:（空）	partOfSpeech:［名］	expl:天空
pronun:それ	writing:null	partOfSpeech:〔代〕	expl:那，那个
pronun:それから	writing:null	partOfSpeech:〔连〕	expl:然后
pronun:それじゃ	writing:null	partOfSpeech:［连］	expl:那么
pronun:それでは	writing:null	partOfSpeech:［连］	expl:那么
pronun:それで	writing:null	partOfSpeech:［连］	expl:因此
pronun:それにすても	writing:null	partOfSpeech:［连］	expl:即便那样，话虽如此
pronun:それに	writing:null	partOfSpeech:［连］	expl:而且
pronun:そろいます	writing:null	partOfSpeech:［动1］	expl:到齐，齐全
pronun:そろえます	writing:null	partOfSpeech:［动2］	expl:备齐，凑齐；使一致
pronun:そろそろ	writing:null	partOfSpeech:〔副〕	expl:快要
pronun:そんなに	writing:null	partOfSpeech:null	expl:那么
pronun:そんな	writing:null	partOfSpeech:null	expl:［连体］那样的
pronun:ぞう	writing:（象）	partOfSpeech:〔名〕	expl:象，大象
pronun:ぞんじています	writing:（存じています）	partOfSpeech:［动2］	expl:（自谦）知道
pronun:たいかい	writing:（大会）	partOfSpeech:［名］	expl:大会
pronun:たいきょくけん	writing:（太極拳）	partOfSpeech:〔名〕	expl:太极拳
pronun:たいざいします	writing:（滞在～）	partOfSpeech:［动3］	expl:停留，滞留
pronun:たいしかん	writing:（大使館）	partOfSpeech:［名］	expl:大使馆
pronun:たいせつ	writing:（大切）	partOfSpeech:〔形2〕	expl:重要，珍贵
pronun:たいど	writing:（態度）	partOfSpeech:［名］	expl:态度
pronun:たいふう	writing:（台風）	partOfSpeech:［名］	expl:台风
pronun:たいへん	writing:null	partOfSpeech:〔副〕	expl:很，非常
pronun:たいへんですね	writing:（大変ですね）	partOfSpeech:null	expl:真不容易，够受的，不得了
pronun:たいへん	writing:（大変）	partOfSpeech:〔形2〕	expl:够受的，不得了
pronun:たいりょう	writing:（大量）	partOfSpeech:［形2］	expl:大量
pronun:たい	writing:（戴）	partOfSpeech:［专］	expl:戴
pronun:たかい	writing:（高い）	partOfSpeech:〔形1〕	expl:高，贵
pronun:たかさ	writing:（高さ）	partOfSpeech:［名］	expl:高度
pronun:たからくじ	writing:（宝くじ）	partOfSpeech:［名］	expl:彩票
pronun:たくさん	writing:null	partOfSpeech:〔名〕	expl:很多
pronun:たくはいびん	writing:（宅配便）	partOfSpeech:［名］	expl:送货上门服务
pronun:たこ	writing:（凧）	partOfSpeech:［名］	expl:风筝
pronun:たしか	writing:null	partOfSpeech:〔副〕	expl:好像是，大概；的确
pronun:たしかめます	writing:（確かめます）	partOfSpeech:〔动2〕	expl:null
pronun:たしか	writing:（確か）	partOfSpeech:［形2］	expl:确实，确切；大概
pronun:たすけます	writing:（助けます）	partOfSpeech:［动2］	expl:救助，帮助
pronun:たずねます	writing:（訪ねます）	partOfSpeech:［动2］	expl:访问，拜访
pronun:たたきます	writing:null	partOfSpeech:［动1］	expl:拍，敲，打
pronun:たたみ	writing:（畳）	partOfSpeech:［名］	expl:草席，草垫
pronun:ただいま	writing:null	partOfSpeech:null	expl:我回来了
pronun:ただいま	writing:（ただ今）	partOfSpeech:［副］	expl:这会儿，方才；马上，立刻
pronun:ただしい	writing:（正しい）	partOfSpeech:［形1］	expl:正确的
pronun:ただし	writing:null	partOfSpeech:［连］	expl:不过，只是
pronun:たちいりきんし	writing:（立入禁止）	partOfSpeech:〔名〕	expl:禁止进入
pronun:たちます	writing:（建ちます）	partOfSpeech:［动1］	expl:盖，建
pronun:たちます	writing:（立ちます）	partOfSpeech:〔动1〕	expl:站，立
pronun:たっきゅうだい	writing:（卓球台）	partOfSpeech:［名］	expl:乒乓球桌
pronun:たっきゅう	writing:（卓球）	partOfSpeech:［名］	expl:乒乓球
pronun:たったいま	writing:（たった今）	partOfSpeech:〔副〕	expl:刚刚
pronun:たてます	writing:（建てます）	partOfSpeech:[动2]	expl:盖，建造
pronun:たてもの	writing:（建物）	partOfSpeech:〔名〕	expl:大楼，建筑物
pronun:たて	writing:（縦）	partOfSpeech:［名］	expl:纵，竖
pronun:たとえば	writing:（例えば）	partOfSpeech:［副］	expl:比如，例如
pronun:たなか	writing:（田中）	partOfSpeech:〔专〕	expl:田中
pronun:たな	writing:（棚）	partOfSpeech:［名］	expl:橱柜，搁板
pronun:たのしい	writing:（楽しい）	partOfSpeech:〔形1〕	expl:愉快，快乐
pronun:たのしみ	writing:（楽しみ）	partOfSpeech:［形2］	expl:愉快，期待
pronun:たのみます	writing:(頼みます)	partOfSpeech:［动1］	expl:点（菜）；请求；托付
pronun:たぶん	writing:null	partOfSpeech:〔副〕	expl:可能，大概
pronun:たべます	writing:（食べます）	partOfSpeech:〔动2〕	expl:吃
pronun:たべもの	writing:（食べ物）	partOfSpeech:〔名〕	expl:食物，食品
pronun:たまごやき	writing:（卵焼き）	partOfSpeech:［名］	expl:煎鸡蛋
pronun:たまご	writing:（卵）	partOfSpeech:〔名〕	expl:鸡蛋
pronun:たまに	writing:null	partOfSpeech:〔副〕	expl:偶尔，很少
pronun:たむら	writing:（田村）	partOfSpeech:［专］	expl:田村
pronun:ためます	writing:null	partOfSpeech:［动2］	expl:积攒，储存
pronun:たります	writing:（足ります）	partOfSpeech:［动2］	expl:足，够
pronun:たろう	writing:（太郎）	partOfSpeech:〔专〕	expl:太郎
pronun:たんい	writing:（単位）	partOfSpeech:［名］	expl:计量单位
pronun:たんじゅん	writing:（単純）	partOfSpeech:［形2］	expl:单纯
pronun:たんじょうび	writing:（誕生日）	partOfSpeech:〔名〕	expl:生日
pronun:たんとうします	writing:（担当～）	partOfSpeech:［动3］	expl:承担
pronun:だいがく	writing:（大学）	partOfSpeech:〔名〕	expl:大学
pronun:だいじょうぶ	writing:（大丈夫）	partOfSpeech:〔形2〕	expl:没关系，放心
pronun:だいじ	writing:（大事）	partOfSpeech:［形2］	expl:重要，宝贵
pronun:だいすき	writing:（大好き）	partOfSpeech:〔形2〕	expl:非常喜欢
pronun:だいたい	writing:null	partOfSpeech:〔副〕	expl:大约，大概，大体
pronun:だいとうりょう	writing:（大統領）	partOfSpeech:〔名〕	expl:总统
pronun:だいぶ	writing:null	partOfSpeech:〔副〕	expl:很，相当地
pronun:だから	writing:null	partOfSpeech:〔连〕	expl:所以，因此
pronun:だします	writing:（出します）	partOfSpeech:〔动1〕	expl:寄（信）
pronun:だって	writing:null	partOfSpeech:［连］	expl:可是，但是
pronun:だめ	writing:null	partOfSpeech:〔形2〕	expl:不行，不可以
pronun:だれ	writing:null	partOfSpeech:〔疑〕	expl:谁
pronun:だんせい	writing:（男性）	partOfSpeech:〔名〕	expl:男性
pronun:だんだん	writing:null	partOfSpeech:［副］	expl:渐渐地，逐渐地
pronun:ちいさい	writing:（小さい）	partOfSpeech:〔形1〕	expl:小
pronun:ちいさな	writing:（小さな）	partOfSpeech:null	expl:［连体］小的
pronun:ちかい	writing:（近い）	partOfSpeech:〔形1〕	expl:近
pronun:ちかく	writing:（近く）	partOfSpeech:〔名〕	expl:附近，近旁
pronun:ちかてつ	writing:（地下鉄）	partOfSpeech:〔名〕	expl:地铁
pronun:ちからづよい	writing:（力強い）	partOfSpeech:［形1］	expl:强有力；心里踏实
pronun:ちがいます	writing:null	partOfSpeech:null	expl:不是
pronun:ちがいます	writing:（違います）	partOfSpeech:〔动1〕	expl:不同，不一样
pronun:ちきゅうおんだんか	writing:（地球温暖化）	partOfSpeech:［名］	expl:地球变暖现象
pronun:ちきゅう	writing:（地球）	partOfSpeech:［名］	expl:地球
pronun:ちこく	writing:（遅刻）	partOfSpeech:〔名〕	expl:迟到
pronun:ちず	writing:（地図）	partOfSpeech:〔名〕	expl:地图
pronun:ちち	writing:（父）	partOfSpeech:〔名〕	expl:（我）父亲
pronun:ちゃんと	writing:null	partOfSpeech:〔副〕	expl:好好地，的确，完全
pronun:ちゅういします	writing:（注意～）	partOfSpeech:［动3］	expl:注意
pronun:ちゅうかがい	writing:（中華街）	partOfSpeech:〔名〕	expl:中华街
pronun:ちゅうかりょうり	writing:（中華料理）	partOfSpeech:〔名〕	expl:中国菜
pronun:ちゅうこ	writing:（中古）	partOfSpeech:［名］	expl:二手货，旧货
pronun:ちゅうごくこうくう	writing:（中国航空）	partOfSpeech:［专］	expl:中国航空
pronun:ちゅうごくご	writing:（中国語）	partOfSpeech:〔名〕	expl:汉语，中文
pronun:ちゅうごくじん	writing:（中国人）	partOfSpeech:〔名〕	expl:中国人
pronun:ちゅうごくぜんど	writing:（中国全土）	partOfSpeech:［名］	expl:全中国
pronun:ちゅうごく	writing:（中国）	partOfSpeech:〔专〕	expl:中国
pronun:ちゅうし	writing:(中止)	partOfSpeech:［名］	expl:中止，中顿
pronun:ちゅうしゃきんし	writing:（駐車禁止）	partOfSpeech:〔名〕	expl:禁止停车
pronun:ちゅうしゃじょう	writing:（駐車場）	partOfSpeech:〔名〕	expl:停车场
pronun:ちゅうしんち	writing:（中心地）	partOfSpeech:［名］	expl:中心地区
pronun:ちょうきよほう	writing:（長期予報）	partOfSpeech:［名］	expl:长期预报
pronun:ちょうこうくだり	writing:（長江下り）	partOfSpeech:［专］	expl:坐船浏览长江两岸风光
pronun:ちょうこく	writing:（彫刻）	partOfSpeech:〔名〕	expl:雕刻
pronun:ちょうさ	writing:（調査）	partOfSpeech:［名］	expl:调查
pronun:ちょうし	writing:（調子）	partOfSpeech:［名］	expl:情况，状况；势头
pronun:ちょうど	writing:null	partOfSpeech:〔副〕	expl:正好，恰好
pronun:ちょう	writing:（張）	partOfSpeech:〔专〕	expl:张
pronun:ちょきんします	writing:(貯金～)	partOfSpeech:［动3］	expl:存钱，储蓄
pronun:ちょくせつ	writing:（直接）	partOfSpeech:［副］	expl:直接
pronun:ちょくつうれっしゃ	writing:（直通列車）	partOfSpeech:［名］	expl:直达列车
pronun:ちょっこうします	writing:（直行～）	partOfSpeech:［动3］	expl:直接去，直达
pronun:ちょっと	writing:null	partOfSpeech:〔副〕	expl:一点儿
pronun:ちん	writing:（陳）	partOfSpeech:〔专〕	expl:陈
pronun:つい	writing:null	partOfSpeech:［副］	expl:不知不觉地，无意中
pronun:つうきんラッシュ	writing:（通勤～）	partOfSpeech:［名］	expl:上下班高峰
pronun:つうきん	writing:（通勤）	partOfSpeech:〔名〕	expl:上下班，通勤
pronun:つうこうきんし	writing:（通行禁止）	partOfSpeech:［名］	expl:禁止通行
pronun:つうじます	writing:（通じます）	partOfSpeech:［动2］	expl:通过，相通
pronun:つかいます	writing:（使います）	partOfSpeech:〔动1〕	expl:用，使用
pronun:つかれます	writing:（疲れます）	partOfSpeech:〔动2〕	expl:疲倦，疲惫
pronun:つきます	writing:（付きます）	partOfSpeech:［动1］	expl:附带，附加
pronun:つきます	writing:（着きます）	partOfSpeech:［动1］	expl:到，到达
pronun:つきます	writing:null	partOfSpeech:［动1］	expl:灯亮，灯开
pronun:つき	writing:（月）	partOfSpeech:［名］	expl:月亮
pronun:つぎ	writing:（次）	partOfSpeech:［名］	expl:这回，下面，下回
pronun:つくえ	writing:（机）	partOfSpeech:〔名〕	expl:桌子，书桌
pronun:つくります	writing:（作ります）	partOfSpeech:〔动1〕	expl:做，制造
pronun:つけます	writing:null	partOfSpeech:〔动2〕	expl:开（灯）
pronun:つけます	writing:（付けます）	partOfSpeech:［动2］	expl:添加，附加
pronun:つげます	writing:（告げます）	partOfSpeech:［动2］	expl:说，告诉
pronun:つごう	writing:（都合）	partOfSpeech:〔名〕	expl:方便；情况
pronun:つたえます	writing:（伝えます）	partOfSpeech:〔动2〕	expl:说，传达，转告
pronun:つつみます	writing:(包みます)	partOfSpeech:［动1］	expl:卷，包裹
pronun:つづきます	writing:（続きます）	partOfSpeech:［动1］	expl:继续，持续
pronun:つづけます	writing:(続けます)	partOfSpeech:［动2］	expl:继续，持续
pronun:つまみぐいします	writing:（つまみ食い～）	partOfSpeech:［动3］	expl:偷吃
pronun:つまらない	writing:null	partOfSpeech:〔形1〕	expl:无聊
pronun:つま	writing:（妻）	partOfSpeech:［名］	expl:妻子
pronun:つめたい	writing:（冷たい）	partOfSpeech:〔形1〕	expl:凉
pronun:つもります	writing:（積もります）	partOfSpeech:［动1］	expl:堆积；积攒
pronun:つゆ	writing:（梅雨）	partOfSpeech:［名］	expl:梅雨
pronun:つよい	writing:（強い）	partOfSpeech:[形1]	expl:强，坚强
pronun:つり	writing:（釣り）	partOfSpeech:〔名〕	expl:钓鱼
pronun:つれます	writing:（連れます）	partOfSpeech:［动2］	expl:带，领
pronun:ていあんします	writing:（提案～）	partOfSpeech:［动3］	expl:建议，提案
pronun:ていかかく	writing:（低価格）	partOfSpeech:［名］	expl:低价（格）
pronun:ていしゅつします	writing:（提出～）	partOfSpeech:［动3］	expl:提交，提出
pronun:ていねいに	writing:（丁寧に）	partOfSpeech:［副］	expl:恭敬地；细心地
pronun:ていねい	writing:（丁寧）	partOfSpeech:［形2］	expl:精心，细心，恭敬
pronun:てかみ	writing:（手紙）	partOfSpeech:〔名〕	expl:信
pronun:てがる	writing:（手軽）	partOfSpeech:［形2］	expl:简便，简单，轻便
pronun:てちょう	writing:（手帳）	partOfSpeech:〔名〕	expl:记事本
pronun:てつだいます	writing:（手伝います）	partOfSpeech:〔动1〕	expl:帮忙
pronun:てつどう	writing:（鉄道）	partOfSpeech:［名］	expl:火车，铁路，铁道
pronun:てつやします	writing:（徹夜～）	partOfSpeech:［动3］	expl:熬通宵，彻夜
pronun:てづくり	writing:（手作り）	partOfSpeech:〔名〕	expl:手工做，自己做，手制
pronun:てんあんはんてん	writing:（天安飯店）	partOfSpeech:［专］	expl:天安饭店
pronun:てんあんもん	writing:（天安門）	partOfSpeech:〔专〕	expl:天安门
pronun:てんいん	writing:（店員）	partOfSpeech:〔名〕	expl:店员
pronun:てんきよほう	writing:（天気予報）	partOfSpeech:［名］	expl:天气预报
pronun:てんきん	writing:（転勤）	partOfSpeech:〔名〕	expl:调动工作
pronun:てんき	writing:（天気）	partOfSpeech:〔名〕	expl:天气
pronun:てんしょくします	writing:（転職～）	partOfSpeech:［动3］	expl:换工作
pronun:てんじじょう	writing:（展示場）	partOfSpeech:〔名〕	expl:展览会场
pronun:てんじょう	writing:（天井）	partOfSpeech:〔名〕	expl:天棚
pronun:てんぷら	writing:（天ぷら）	partOfSpeech:〔名〕	expl:天麸罗
pronun:てんらんかい	writing:（展覧会）	partOfSpeech:〔名〕	expl:展览会
pronun:て	writing:（手）	partOfSpeech:［名］	expl:手
pronun:でいか	writing:（定価）	partOfSpeech:〔名〕	expl:定价
pronun:でかけます	writing:（出かけます）	partOfSpeech:〔动2〕	expl:外出，出门
pronun:できごと	writing:（出来事）	partOfSpeech:［名］	expl:事情，事件
pronun:できます	writing:null	partOfSpeech:〔动2〕	expl:会；能；完成
pronun:でくるだけ	writing:null	partOfSpeech:null	expl:尽量，尽可能
pronun:ですから	writing:null	partOfSpeech:〔连〕	expl:所以，因此
pronun:では	writing:null	partOfSpeech:〔连〕	expl:那么
pronun:でます	writing:（出ます）	partOfSpeech:〔动2〕	expl:离开
pronun:でむかえ	writing:（出迎え）	partOfSpeech:〔名〕	expl:迎接
pronun:でも	writing:null	partOfSpeech:〔连〕	expl:可是，不过
pronun:でんおばんごう	writing:（電話番号）	partOfSpeech:〔名〕	expl:电话号码
pronun:でんき	writing:（電気）	partOfSpeech:〔名〕	expl:电，电力
pronun:でんげん	writing:（電源）	partOfSpeech:［名］	expl:电源
pronun:でんしゃ	writing:（電車）	partOfSpeech:〔名〕	expl:电车
pronun:でんとうてき	writing:（伝統的）	partOfSpeech:［名］	expl:传统的
pronun:でんわ	writing:（電話）	partOfSpeech:〔名〕	expl:电话
pronun:とうきょうえき	writing:（東京駅）	partOfSpeech:〔专〕	expl:东京站
pronun:とうきょうだいがく	writing:（東京大学）	partOfSpeech:〔专〕	expl:东京大学
pronun:とうきょうりょうりスクール	writing:（東京料理～）	partOfSpeech:［专］	expl:东京厨师学校
pronun:とうきょうタワー	writing:（東京～）	partOfSpeech:〔专〕	expl:东京塔
pronun:とうきょう	writing:（東京）	partOfSpeech:〔专〕	expl:东京
pronun:とうさんします	writing:（倒産～）	partOfSpeech:［动3］	expl:倒闭，破产
pronun:とうぜん	writing:（当然）	partOfSpeech:［形2］	expl:当然，应当
pronun:とうだい	writing:（東大）	partOfSpeech:［专］	expl:东大，东京大学
pronun:とうちゃく	writing:(到着)	partOfSpeech:［名］	expl:到达，抵达
pronun:とうとう	writing:null	partOfSpeech:〔副〕	expl:终于，终究，到底
pronun:とう	writing:（唐）	partOfSpeech:［专］	expl:唐
pronun:とおい	writing:（遠い）	partOfSpeech:〔形1〕	expl:远
pronun:とおく	writing:（遠く）	partOfSpeech:［名］	expl:远处，远方
pronun:とおりぬけます	writing:（通り抜けます）	partOfSpeech:［动2］	expl:走得出去，穿过，通过
pronun:とおります	writing:（通ります）	partOfSpeech:〔动1〕	expl:通过，经过
pronun:とおり	writing:（通り）	partOfSpeech:〔名〕	expl:大街
pronun:ときどき	writing:（時々）	partOfSpeech:〔副〕	expl:有时，时不时
pronun:とくい	writing:（得意）	partOfSpeech:［形2］	expl:擅长
pronun:とくぎ	writing:（特技）	partOfSpeech:〔名〕	expl:特长，拿手的技术
pronun:とくてん	writing:（特典）	partOfSpeech:［名］	expl:优惠
pronun:とくに	writing:（特に）	partOfSpeech:〔副〕	expl:特别
pronun:とくべつ	writing:（特別）	partOfSpeech:［形2］	expl:特别
pronun:とけい	writing:（時計）	partOfSpeech:〔名〕	expl:钟，表
pronun:ところで	writing:null	partOfSpeech:〔连〕	expl:（转换话题） 哎
pronun:ところ	writing:（所）	partOfSpeech:〔名〕	expl:场所
pronun:としうえ	writing:（年上）	partOfSpeech:［名］	expl:年长者
pronun:としょかん	writing:（図書館）	partOfSpeech:〔名〕	expl:图书馆
pronun:としょしつ	writing:（図書室）	partOfSpeech:〔名〕	expl:图书室
pronun:とつぜん	writing:（突然）	partOfSpeech:［副］	expl:突然
pronun:とても	writing:null	partOfSpeech:〔副〕	expl:很，非常
pronun:ととのいます	writing:（整います）	partOfSpeech:［动1］	expl:齐备，完备
pronun:とどきます	writing:（届きます）	partOfSpeech:〔动1〕	expl:收到，送到，寄到
pronun:とどけます	writing:（届けます）	partOfSpeech:［动2］	expl:送到，送去
pronun:となり	writing:（隣）	partOfSpeech:〔名〕	expl:旁边
pronun:とにかく	writing:null	partOfSpeech:［副］	expl:特别是，总之
pronun:とびます	writing:（飛びます）	partOfSpeech:〔动1〕	expl:飞，飞行
pronun:とまります	writing:(泊まります)	partOfSpeech:［动1］	expl:住，过夜，住宿
pronun:とまります	writing:（止まります）	partOfSpeech:［动1］	expl:停，停住
pronun:とめます	writing:（止めます）	partOfSpeech:〔动2〕	expl:停，制止
pronun:ともだち	writing:（友達）	partOfSpeech:〔名〕	expl:朋友
pronun:とりあえず	writing:null	partOfSpeech:〔副〕	expl:暂且
pronun:とりかえます	writing:（取り替えます）	partOfSpeech:［动2］	expl:更换，交换
pronun:とります	writing:null	partOfSpeech:〔动1〕	expl:取，取得
pronun:とります	writing:（取ります）	partOfSpeech:［动1］	expl:印，记下
pronun:とります	writing:（撮ります）	partOfSpeech:〔动1〕	expl:拍照，拍摄
pronun:とり	writing:（鳥）	partOfSpeech:［名］	expl:鸟
pronun:どう	writing:null	partOfSpeech:〔副〕	expl:怎样，如何
pronun:どういたしまして	writing:null	partOfSpeech:null	expl:没关系
pronun:どうぐ	writing:（道具）	partOfSpeech:〔名〕	expl:工具
pronun:どうして	writing:null	partOfSpeech:〔副〕	expl:为什么
pronun:どうぞ	writing:null	partOfSpeech:null	expl:请
pronun:どうですか	writing:null	partOfSpeech:null	expl:怎样，如何
pronun:どうぶつえん	writing:（動物園）	partOfSpeech:〔名〕	expl:动物园
pronun:どうも	writing:null	partOfSpeech:〔副〕	expl:非常，很
pronun:どうもすみません	writing:null	partOfSpeech:null	expl:实在对不起
pronun:どうやって	writing:null	partOfSpeech:null	expl:怎样，如何
pronun:どうりょう	writing:（同僚）	partOfSpeech:［名］	expl:同事
pronun:どうろこうじ	writing:（道路工事）	partOfSpeech:［名］	expl:道路施工
pronun:どうろ	writing:（道路）	partOfSpeech:[名]	expl:道路，马路
pronun:どくしょ	writing:（読書）	partOfSpeech:［名］	expl:读书
pronun:どこ	writing:null	partOfSpeech:〔疑〕	expl:哪里，哪儿
pronun:どちら	writing:null	partOfSpeech:〔疑〕	expl:哪儿，哪边
pronun:どなた	writing:null	partOfSpeech:〔疑〕	expl:哪位
pronun:どの	writing:null	partOfSpeech:null	expl:〔连体〕 哪个
pronun:どのぐらい	writing:null	partOfSpeech:null	expl:多久，多少钱
pronun:どのへん	writing:（どの辺）	partOfSpeech:null	expl:哪儿
pronun:どようび	writing:（土曜日）	partOfSpeech:〔名〕	expl:星期六
pronun:どれ	writing:null	partOfSpeech:〔疑〕	expl:哪个
pronun:どれぐらい	writing:null	partOfSpeech:null	expl:多久，多少钱
pronun:どろぼう	writing:（泥棒）	partOfSpeech:〔名〕	expl:小偷，盗贼
pronun:どんどん	writing:null	partOfSpeech:［副］	expl:连接不断地，接二连三地
pronun:どんな	writing:null	partOfSpeech:〔疑〕	expl:什么样的，怎样的
pronun:ないよう	writing:（内容）	partOfSpeech:［名］	expl:内容
pronun:なおします	writing:（直します）	partOfSpeech:〔动1〕	expl:改，修改，改正
pronun:なおります	writing:（治ります）	partOfSpeech:〔动1〕	expl:痊愈，医好
pronun:なかた	writing:（中田）	partOfSpeech:［专］	expl:中田
pronun:なかなか	writing:null	partOfSpeech:〔副〕	expl:相当，很，非常
pronun:なかむら	writing:（中村）	partOfSpeech:〔专〕	expl:中村
pronun:なか	writing:（中）	partOfSpeech:〔名〕	expl:里面，内部，中间
pronun:なか	writing:（仲）	partOfSpeech:［名］	expl:关系，友情，友谊
pronun:ながい	writing:（長い）	partOfSpeech:〔形1〕	expl:长，长久，长远
pronun:ながさ	writing:（長さ）	partOfSpeech:［名］	expl:长度
pronun:ながしま	writing:（長島）	partOfSpeech:〔专〕	expl:长岛
pronun:ながめ	writing:（眺め）	partOfSpeech:〔名〕	expl:景色，风景
pronun:なきます	writing:（泣きます）	partOfSpeech:［动1］	expl:哭，哭泣
pronun:なきます	writing:（鳴きます）	partOfSpeech:［动1］	expl:叫，鸣，啼
pronun:なくします	writing:null	partOfSpeech:〔动1〕	expl:丢，丢失
pronun:なくなります	writing:null	partOfSpeech:［动1］	expl:完，丢失
pronun:なごや	writing:（名古屋）	partOfSpeech:〔专〕	expl:名古屋
pronun:なさいます	writing:null	partOfSpeech:［动1］	expl:（尊他）做，干
pronun:なつやすみ	writing:（夏休み）	partOfSpeech:〔名〕	expl:暑假
pronun:なつ	writing:（夏）	partOfSpeech:〔名〕	expl:夏天
pronun:など	writing:null	partOfSpeech:null	expl:null
pronun:なまえ	writing:（名前）	partOfSpeech:〔名〕	expl:姓名
pronun:なまビール	writing:（生～）	partOfSpeech:〔名〕	expl:生啤
pronun:なやみ	writing:（悩み）	partOfSpeech:［名］	expl:烦恼
pronun:ならいます	writing:（習います）	partOfSpeech:〔动1〕	expl:学习
pronun:ならびます	writing:（並びます）	partOfSpeech:［动1］	expl:排队，排，列队
pronun:ならべます	writing:(並べます)	partOfSpeech:［动2］	expl:排列
pronun:なら	writing:（奈良）	partOfSpeech:〔专〕	expl:奈良
pronun:なります	writing:null	partOfSpeech:〔动1〕	expl:变，当，变成，成为
pronun:なります	writing:（鳴ります）	partOfSpeech:［动1］	expl:鸣响，响起
pronun:なれます	writing:（慣れます）	partOfSpeech:［动2］	expl:习惯
pronun:なんか	writing:null	partOfSpeech:［副］	expl:有点，总觉得，有些，好像
pronun:なんだか	writing:null	partOfSpeech:［副］	expl:总觉得，总有点
pronun:なんといっても	writing:（何と言っても）	partOfSpeech:null	expl:首先是，无论如何
pronun:なんのおかまいもしませんで	writing:（何のお構いもしませんで）	partOfSpeech:null	expl:招待不周
pronun:なん	writing:（何）	partOfSpeech:〔疑〕	expl:什么
pronun:にあいます	writing:（似合います）	partOfSpeech:〔动1〕	expl:适合，相称
pronun:におい	writing:null	partOfSpeech:［名］	expl:味道，气味
pronun:にがい	writing:（苦い）	partOfSpeech:〔形1〕	expl:苦
pronun:にがて	writing:（苦手）	partOfSpeech:〔形2〕	expl:不擅长，不善于
pronun:にぎやか	writing:null	partOfSpeech:〔形2〕	expl:热闹，繁华
pronun:にくじゃが	writing:（肉じゃが）	partOfSpeech:〔名〕	expl:土豆炖肉
pronun:にく	writing:（肉）	partOfSpeech:〔名〕	expl:肉
pronun:にげます	writing:（逃げます）	partOfSpeech:［动2］	expl:逃跑
pronun:にしちょうあんがい	writing:（西長安街）	partOfSpeech:［专］	expl:西长安街
pronun:にちじょうかいわ	writing:（日常会話）	partOfSpeech:［名］	expl:日常会话
pronun:にちようび	writing:（日曜日）	partOfSpeech:〔名〕	expl:星期日
pronun:にっき	writing:（日記）	partOfSpeech:［名］	expl:日记
pronun:にっちゅうしょうじ	writing:（日中商事）	partOfSpeech:〔专〕	expl:日中商社
pronun:にっちゅうでんき	writing:（日中電気）	partOfSpeech:〔专〕	expl:日中电器
pronun:にってい	writing:（日程）	partOfSpeech:［名］	expl:日程
pronun:にほんご	writing:（日本語）	partOfSpeech:〔名〕	expl:日语
pronun:にほんしゅ	writing:（日本酒）	partOfSpeech:〔名〕	expl:日本酒
pronun:にほんしょく	writing:（日本食）	partOfSpeech:［名］	expl:日本食品
pronun:にほんじん	writing:（日本人）	partOfSpeech:〔名〕	expl:日本人
pronun:にほんぶんか	writing:（日本文化）	partOfSpeech:［名］	expl:日本文化
pronun:にほんりょうり	writing:（日本料理）	partOfSpeech:〔名〕	expl:日式饭菜
pronun:にほん	writing:（日本）	partOfSpeech:〔专〕	expl:日本
pronun:にます	writing:（似ます）	partOfSpeech:［动2］	expl:像，相似
pronun:にもつ	writing:（荷物）	partOfSpeech:〔名〕	expl:包裹
pronun:にゅういんします	writing:（入院～）	partOfSpeech:［动3］	expl:住院
pronun:にゅうえんりょう	writing:（入園料）	partOfSpeech:［名］	expl:门票，入园费
pronun:にゅうがくあんない	writing:（入学案内）	partOfSpeech:［名］	expl:入学指南
pronun:にゅうがくします	writing:（入学～）	partOfSpeech:［动3］	expl:入学
pronun:にゅうしゃします	writing:（入社～）	partOfSpeech:［动3］	expl:入社
pronun:にゅうじょうりょう	writing:（入場料）	partOfSpeech:〔名〕	expl:门票，进场费
pronun:にゅじょうけん	writing:（入場券）	partOfSpeech:［名］	expl:入场卷，门票
pronun:にわ	writing:（庭）	partOfSpeech:〔名〕	expl:院子
pronun:にんきがあります	writing:（人気があります）	partOfSpeech:null	expl:受欢迎
pronun:にんき	writing:（人気）	partOfSpeech:〔名〕	expl:声望，受欢迎
pronun:にんぎょう	writing:（人形）	partOfSpeech:〔名〕	expl:玩偶
pronun:にんげん	writing:（人間）	partOfSpeech:［名］	expl:人，人类
pronun:ぬぎます	writing:（脱ぎます）	partOfSpeech:〔动1〕	expl:脱
pronun:ぬすみます	writing:（盗みます）	partOfSpeech:［动1］	expl:盗取，偷盗
pronun:ぬの	writing:（布）	partOfSpeech:〔名〕	expl:布，布匹
pronun:ぬれます	writing:null	partOfSpeech:［动2］	expl:淋湿，打湿
pronun:ねこ	writing:（猫）	partOfSpeech:〔名〕	expl:猫
pronun:ねだん	writing:（値段）	partOfSpeech:〔名〕	expl:价格
pronun:ねつ	writing:（熱）	partOfSpeech:〔名〕	expl:发烧，体温
pronun:ねぼうします	writing:（寝坊～）	partOfSpeech:〔动3〕	expl:睡懒觉
pronun:ねます	writing:（寝ます）	partOfSpeech:〔动2〕	expl:睡觉
pronun:ねむい	writing:（眠い）	partOfSpeech:〔形1〕	expl:困倦
pronun:ねむります	writing:（眠ります）	partOfSpeech:［动1］	expl:睡觉
pronun:ねんねん	writing:（年々）	partOfSpeech:［副］	expl:逐年，每年
pronun:のこります	writing:(残ります)	partOfSpeech:［动1］	expl:剩余，剩下
pronun:のぞみ	writing:null	partOfSpeech:［专］	expl:＂希望号＂［新干线的名称］
pronun:のど	writing:null	partOfSpeech:〔名〕	expl:喉咙
pronun:のばします	writing:（延ばします）	partOfSpeech:［动1］	expl:延长
pronun:のぼります	writing:（登ります）	partOfSpeech:〔动1〕	expl:登，上
pronun:のみます	writing:（飲みます）	partOfSpeech:〔动1〕	expl:喝
pronun:のみもの	writing:（飲み物）	partOfSpeech:〔名〕	expl:饮料
pronun:のりかえます	writing:（乗り換えます）	partOfSpeech:［动2］	expl:换乘
pronun:のりかえ	writing:（乗り換え）	partOfSpeech:［名］	expl:换车，换乘
pronun:のります	writing:（乗ります）	partOfSpeech:〔动1〕	expl:乘坐，乘
pronun:のりもの	writing:（乗り物）	partOfSpeech:［名］	expl:乘坐物
pronun:はい	writing:null	partOfSpeech:〔叹〕	expl:哎，是（应答）；是的
pronun:はいけんします	writing:（拝見～）	partOfSpeech:［动3］	expl:（自谦）看
pronun:はいざら	writing:（灰皿）	partOfSpeech:［名］	expl:烟灰缸
pronun:はいります	writing:（入ります）	partOfSpeech:〔动1〕	expl:进入，加入
pronun:はかりうり	writing:（量り売り）	partOfSpeech:［名］	expl:称斤卖，论重量卖
pronun:はかります	writing:（図ります）	partOfSpeech:［动1］	expl:谋求；考虑
pronun:はがき	writing:null	partOfSpeech:〔名〕	expl:明信片
pronun:はきけ	writing:（吐き気）	partOfSpeech:［名］	expl:恶心，想要呕吐
pronun:はきます	writing:null	partOfSpeech:［动1］	expl:穿（鞋，裤子）
pronun:はくちょう	writing:（白鳥）	partOfSpeech:［名］	expl:鹅
pronun:はこね	writing:（箱根）	partOfSpeech:〔专〕	expl:箱根
pronun:はこびます	writing:（運びます）	partOfSpeech:〔动1〕	expl:搬运
pronun:はこ	writing:（箱）	partOfSpeech:〔名〕	expl:盒子，箱子
pronun:はさみ	writing:null	partOfSpeech:［名］	expl:剪刀
pronun:はし	writing:null	partOfSpeech:〔名〕	expl:筷子
pronun:はしります	writing:（走ります）	partOfSpeech:［动1］	expl:跑，奔跑
pronun:はし	writing:（橋）	partOfSpeech:〔名〕	expl:桥，桥梁
pronun:はじまります	writing:（始まります）	partOfSpeech:〔动1〕	expl:开始
pronun:はじめて	writing:（初めて）	partOfSpeech:〔副〕	expl:第一次
pronun:はじめまして	writing:null	partOfSpeech:null	expl:初次见面
pronun:はじめます	writing:（始めます）	partOfSpeech:〔动2〕	expl:开始
pronun:はじめ	writing:（初め）	partOfSpeech:［名］	expl:最初
pronun:はずかしい	writing:（恥ずかしい）	partOfSpeech:［形1］	expl:害羞，难为情
pronun:はたらきます	writing:（働きます）	partOfSpeech:〔动1〕	expl:工作
pronun:はっけんします	writing:（発見～）	partOfSpeech:［动3］	expl:发现
pronun:はっそうします	writing:（発送～）	partOfSpeech:［动3］	expl:发送，寄送
pronun:はったつれい	writing:（八達嶺）	partOfSpeech:［专］	expl:八达岭
pronun:はっぴょうかい	writing:(発表会)	partOfSpeech:［名］	expl:发布会
pronun:はつおん	writing:（発音）	partOfSpeech:［名］	expl:发音
pronun:はつげんします	writing:（発言～）	partOfSpeech:［动3］	expl:发言
pronun:はつばいします	writing:（発売～）	partOfSpeech:［动3］	expl:上市，发售，出售
pronun:はつめいします	writing:（発明～）	partOfSpeech:［动3］	expl:发明
pronun:はつもうで	writing:（初詣）	partOfSpeech:〔名〕	expl:新年后首次参拜
pronun:はで	writing:（派手）	partOfSpeech:〔形2〕	expl:耀眼，花哨
pronun:はなします	writing:（話します）	partOfSpeech:〔动1〕	expl:说话，说
pronun:はなし	writing:（話）	partOfSpeech:〔名〕	expl:说话
pronun:はなたば	writing:(花束)	partOfSpeech:［名］	expl:花束
pronun:はなや	writing:（花屋）	partOfSpeech:〔名〕	expl:花店
pronun:はな	writing:（花）	partOfSpeech:〔名〕	expl:花
pronun:はな	writing:（鼻）	partOfSpeech:〔名〕	expl:鼻，鼻子
pronun:はは	writing:（母）	partOfSpeech:〔名〕	expl:（我）母亲
pronun:はばひろい	writing:（幅広い）	partOfSpeech:［形1］	expl:广泛，宽广，辽阔
pronun:はやい	writing:（早い）	partOfSpeech:〔形1〕	expl:早
pronun:はやい	writing:（速い）	partOfSpeech:〔形1〕	expl:快
pronun:はやく	writing:（早く）	partOfSpeech:〔副〕	expl:早点儿
pronun:はやさ	writing:（速さ）	partOfSpeech:［名］	expl:速度
pronun:はやし	writing:（林）	partOfSpeech:〔专〕	expl:林
pronun:はらいます	writing:（払います）	partOfSpeech:〔动1〕	expl:支付
pronun:はります	writing:null	partOfSpeech:［动1］	expl:粘，贴
pronun:はる	writing:（春）	partOfSpeech:〔名〕	expl:春天，春季
pronun:はれます	writing:（晴れます）	partOfSpeech:［动2］	expl:晴朗，天晴
pronun:はれ	writing:（晴れ）	partOfSpeech:〔名〕	expl:晴天
pronun:はんがく	writing:（半額）	partOfSpeech:〔名〕	expl:半价
pronun:はんたい	writing:(反対)	partOfSpeech:［名］	expl:反对
pronun:はんつき	writing:（半月）	partOfSpeech:［名］	expl:半月，半个月
pronun:はんぶん	writing:（半分）	partOfSpeech:［名］	expl:一半
pronun:は	writing:（歯）	partOfSpeech:［名］	expl:叶子
pronun:は	writing:（歯）	partOfSpeech:［名］	expl:牙齿
pronun:ばあい	writing:（場合）	partOfSpeech:［名］	expl:场合，情况
pronun:ばいてん	writing:（売店）	partOfSpeech:〔名〕	expl:小卖部，售货亭
pronun:ばい	writing:（倍）	partOfSpeech:［名］	expl:倍，加倍
pronun:ばしょ	writing:（場所）	partOfSpeech:〔名〕	expl:所在地，地方，场所
pronun:ばんぐみ	writing:（番組）	partOfSpeech:［名］	expl:节目
pronun:ばんごう	writing:（番号）	partOfSpeech:［名］	expl:号码，番号
pronun:ばんごはん	writing:（晩ご飯）	partOfSpeech:〔名〕	expl:晚饭
pronun:ばんぱく	writing:（万博）	partOfSpeech:［名］	expl:世博会，万国博览会
pronun:ばんゆういんりょくのほうそく	writing:（万有引力の法則）	partOfSpeech:null	expl:万有引力定律
pronun:ばん	writing:（晩）	partOfSpeech:〔名〕	expl:晚上
pronun:ば	writing:（馬）	partOfSpeech:〔专〕	expl:马
pronun:ひえます	writing:（冷えます）	partOfSpeech:［动2］	expl:变冷；感觉凉
pronun:ひかえめ	writing:（控えめ）	partOfSpeech:［形2］	expl:分量少，节制，控制；拘谨
pronun:ひかりデパート	writing:（光～）	partOfSpeech:［专］	expl:阳光百货商店
pronun:ひきだし	writing:（引き出し）	partOfSpeech:〔名〕	expl:抽屉
pronun:ひきます	writing:（引きます）	partOfSpeech:［动1］	expl:拉，抽
pronun:ひきます	writing:（弾きます）	partOfSpeech:〔动1〕	expl:弹
pronun:ひくい	writing:（低い）	partOfSpeech:〔形1〕	expl:低
pronun:ひこうき	writing:（飛行機）	partOfSpeech:〔名〕	expl:飞机
pronun:ひさしぶり	writing:（久しぶり）	partOfSpeech:［名］	expl:好久不见
pronun:ひじょうに	writing:(非常に)	partOfSpeech:［副］	expl:非常
pronun:ひすい	writing:null	partOfSpeech:［名］	expl:翡翠
pronun:ひだり	writing:（左）	partOfSpeech:〔名〕	expl:左，左边
pronun:ひっこします	writing:（引っ越します）	partOfSpeech:［动1］	expl:搬迁
pronun:ひっこし	writing:（引っ越し）	partOfSpeech:［名］	expl:搬家
pronun:ひっぱります	writing:（引っ張ります）	partOfSpeech:［动1］	expl:拉，拽
pronun:ひつよう	writing:（必要）	partOfSpeech:［形2］	expl:必要，必须
pronun:ひとりぐらし	writing:（一人暮らし）	partOfSpeech:〔名〕	expl:单身生活
pronun:ひと	writing:（人）	partOfSpeech:〔名〕	expl:人
pronun:ひどい	writing:null	partOfSpeech:［形1］	expl:严重，厉害
pronun:ひどい	writing:null	partOfSpeech:［形1］	expl:残酷，过分；激烈
pronun:ひま	writing:（暇）	partOfSpeech:〔形2〕	expl:空闲
pronun:ひやします	writing:（冷やします）	partOfSpeech:［动1］	expl:冰镇，冷却
pronun:ひょうげん	writing:(表現)	partOfSpeech:［名］	expl:表达，表现
pronun:ひょうしき	writing:（標識）	partOfSpeech:［名］	expl:标记
pronun:ひょうばん	writing:（評判）	partOfSpeech:［名］	expl:评价，评论
pronun:ひょう	writing:（表）	partOfSpeech:［名］	expl:表
pronun:ひよう	writing:（費用）	partOfSpeech:［名］	expl:费用
pronun:ひらがな	writing:（平仮名）	partOfSpeech:［名］	expl:平假名
pronun:ひらきます	writing:（開きます）	partOfSpeech:［动1］	expl:开，开张
pronun:ひるごはん	writing:（昼ご飯）	partOfSpeech:〔名〕	expl:午饭
pronun:ひるま	writing:（昼間）	partOfSpeech:［名］	expl:白天，白日
pronun:ひるやすみ	writing:（昼休み）	partOfSpeech:〔名〕	expl:午休
pronun:ひる	writing:（昼）	partOfSpeech:〔名〕	expl:白天，中午
pronun:ひろいます	writing:（拾います）	partOfSpeech:［动1］	expl:捡，拾
pronun:ひろい	writing:（広い）	partOfSpeech:〔形1〕	expl:广阔，宽敞
pronun:ひろがります	writing:（広がります）	partOfSpeech:［动1］	expl:蔓延，拓宽
pronun:ひろさ	writing:（広さ）	partOfSpeech:［名］	expl:面积
pronun:ひろしま	writing:（広島）	partOfSpeech:〔专〕	expl:广岛
pronun:ひんしつ	writing:（品質）	partOfSpeech:［名］	expl:质量，品质
pronun:ひ	writing:（日）	partOfSpeech:〔名〕	expl:日子
pronun:ひ	writing:（火）	partOfSpeech:〔名〕	expl:火
pronun:びしょぬれ	writing:null	partOfSpeech:［名］	expl:落汤鸡，湿透，濡湿
pronun:びじゅつかん	writing:（美術館）	partOfSpeech:〔名〕	expl:美术馆
pronun:びっくりします	writing:null	partOfSpeech:［动3］	expl:吃惊，吓一跳
pronun:びょういん	writing:（病院）	partOfSpeech:〔名〕	expl:医院
pronun:びょうき	writing:（病気）	partOfSpeech:〔名〕	expl:疾病
pronun:びわこ	writing:（琵琶湖）	partOfSpeech:［专］	expl:琵琶湖
pronun:びん	writing:（便）	partOfSpeech:［名］	expl:航班
pronun:ふえます	writing:（増えます）	partOfSpeech:［动2］	expl:增加，增多
pronun:ふかい	writing:（深い）	partOfSpeech:［形1］	expl:深
pronun:ふかさ	writing:（深さ）	partOfSpeech:［名］	expl:深度
pronun:ふきます	writing:（吹きます）	partOfSpeech:［动1］	expl:吹
pronun:ふきゅうします	writing:（普及～）	partOfSpeech:［动3］	expl:普及
pronun:ふくざつさ	writing:（複雑さ）	partOfSpeech:［名］	expl:复杂程度
pronun:ふくざつ	writing:（複雑）	partOfSpeech:〔形2〕	expl:复杂，繁杂
pronun:ふくしゅうします	writing:（復習～）	partOfSpeech:［动3］	expl:复习
pronun:ふく	writing:（服）	partOfSpeech:〔名〕	expl:衣服
pronun:ふじさん	writing:（富士山）	partOfSpeech:〔专〕	expl:富士山
pronun:ふじ	writing:（富士）	partOfSpeech:［专］	expl:富士
pronun:ふせぎます	writing:（防ぎます）	partOfSpeech:［动1］	expl:防御，防备，防守
pronun:ふつう	writing:（普通）	partOfSpeech:［名］	expl:一般，普通
pronun:ふとい	writing:（太い）	partOfSpeech:〔形1〕	expl:粗，胖
pronun:ふとさ	writing:（太さ）	partOfSpeech:［名］	expl:粗（度）
pronun:ふとります	writing:（太ります）	partOfSpeech:〔动1〕	expl:胖
pronun:ふどうさんや	writing:（不動産屋）	partOfSpeech:［名］	expl:房产公司
pronun:ふなびん	writing:（船便）	partOfSpeech:〔名〕	expl:海运
pronun:ふね	writing:（船）	partOfSpeech:〔名〕	expl:船
pronun:ふべん	writing:（不便）	partOfSpeech:〔形2〕	expl:不方便
pronun:ふみます	writing:（踏みます）	partOfSpeech:［动1］	expl:踩，踏
pronun:ふゆやすみ	writing:（冬休み）	partOfSpeech:〔名〕	expl:寒假
pronun:ふゆ	writing:（冬）	partOfSpeech:〔名〕	expl:冬天，冬季
pronun:ふります	writing:（振ります）	partOfSpeech:［动1］	expl:挥动，摆动
pronun:ふります	writing:（降ります）	partOfSpeech:〔动1〕	expl:下（雨，雪），降（雨，雪）
pronun:ふるい	writing:（古い）	partOfSpeech:〔形1〕	expl:旧
pronun:ふんいき	writing:（雰囲気）	partOfSpeech:［名］	expl:气氛
pronun:ぶか	writing:（部下）	partOfSpeech:［名］	expl:部下
pronun:ぶたい	writing:（舞台）	partOfSpeech:［名］	expl:舞台
pronun:ぶちょう	writing:（部長）	partOfSpeech:〔名〕	expl:部长
pronun:ぶっか	writing:（物価）	partOfSpeech:［名］	expl:物价
pronun:ぶつけます	writing:null	partOfSpeech:［动2］	expl:碰上，撞上；扔，投，掷
pronun:ぶひんこうじょう	writing:（部品工場）	partOfSpeech:[名]	expl:零件制造厂
pronun:ぶひん	writing:（部品）	partOfSpeech:［名］	expl:零部件
pronun:ぶんしょう	writing:（文章）	partOfSpeech:［名］	expl:文章
pronun:へいきんきおん	writing:（平均気温）	partOfSpeech:［名］	expl:平均气温
pronun:へいきんねんれい	writing:（平均年齢）	partOfSpeech:［名］	expl:平均年龄
pronun:へいしゃ	writing:（弊社）	partOfSpeech:［名］	expl:敝公司
pronun:へいじつ	writing:（平日）	partOfSpeech:〔名〕	expl:平日，非休息日
pronun:へいてんじこく	writing:（閉店時刻）	partOfSpeech:〔名〕	expl:关门时间
pronun:へえ	writing:null	partOfSpeech:［叹］	expl:哎，哎呀，哎哟
pronun:へた	writing:（下手）	partOfSpeech:〔形2〕	expl:不高明，水平低
pronun:へやだい	writing:（部屋代）	partOfSpeech:［名］	expl:房租
pronun:へや	writing:（部屋）	partOfSpeech:〔名〕	expl:房间，屋子
pronun:へります	writing:（減ります）	partOfSpeech:[动1]	expl:减少
pronun:へん	writing:null	partOfSpeech:［形2］	expl:不恰当，奇怪，反常
pronun:べっそう	writing:（別荘）	partOfSpeech:〔名〕	expl:别墅
pronun:べつに	writing:（別に）	partOfSpeech:［副］	expl:并不
pronun:べつめい	writing:（別名）	partOfSpeech:［名］	expl:别名
pronun:べんきょうします	writing:（勉強～）	partOfSpeech:〔动3〕	expl:学习
pronun:べんりさ	writing:（便利さ）	partOfSpeech:［名］	expl:方便程度
pronun:べんり	writing:（便利）	partOfSpeech:〔形2〕	expl:方便
pronun:べん	writing:（便）	partOfSpeech:［名］	expl:方便，便利
pronun:ぺらぺら	writing:null	partOfSpeech:［副］	expl:流利地
pronun:ぺキンダック	writing:（北京～）	partOfSpeech:〔名〕	expl:北京烤鸭
pronun:ほうこくします	writing:（報告～）	partOfSpeech:〔动3〕	expl:报告
pronun:ほうこくしょ	writing:（報告書）	partOfSpeech:［名］	expl:报告书
pronun:ほうさく	writing:（豊作）	partOfSpeech:［名］	expl:丰收
pronun:ほうそうします	writing:（放送～）	partOfSpeech:［动3］	expl:广播，播送
pronun:ほうもんします	writing:(訪問～)	partOfSpeech:［动3］	expl:拜访，访问
pronun:ほうりつ	writing:（法律）	partOfSpeech:〔名〕	expl:法律
pronun:ほう	writing:（方）	partOfSpeech:［名］	expl:方，方面
pronun:ほか	writing:null	partOfSpeech:〔名〕	expl:另外，其他
pronun:ほかに	writing:null	partOfSpeech:［副］	expl:另外
pronun:ほしい	writing:（欲しい）	partOfSpeech:〔形1〕	expl:想要
pronun:ほそい	writing:（細い）	partOfSpeech:〔形1〕	expl:小，细长，纤细
pronun:ほっかいどう	writing:（北海道）	partOfSpeech:〔专〕	expl:北海道
pronun:ほとんど	writing:null	partOfSpeech:［副］	expl:大部分，几乎
pronun:ほほえみます	writing:null	partOfSpeech:［动1］	expl:微笑
pronun:ほめます	writing:null	partOfSpeech:［动2］	expl:表扬，赞扬
pronun:ほら	writing:null	partOfSpeech:〔叹〕	expl:你看，瞧，喂
pronun:ほんだな	writing:（本棚）	partOfSpeech:〔名〕	expl:书架
pronun:ほんとうに	writing:（本当に）	partOfSpeech:〔副〕	expl:真的，实在是
pronun:ほんとう	writing:（本当）	partOfSpeech:〔形2〕	expl:真的，真正
pronun:ほんと	writing:null	partOfSpeech:［形2］	expl:真的
pronun:ほんば	writing:（本場）	partOfSpeech:［名］	expl:原产地，发源地
pronun:ほんもの	writing:（本物）	partOfSpeech:［名］	expl:真货，真东西
pronun:ほんやくします	writing:（翻訳～）	partOfSpeech:［动3］	expl:翻译，笔译
pronun:ほんや	writing:（本屋）	partOfSpeech:〔名〕	expl:书店
pronun:ほん	writing:（本）	partOfSpeech:〔名〕	expl:书
pronun:ぼうし	writing:（帽子）	partOfSpeech:［名］	expl:帽子
pronun:ぼく	writing:null	partOfSpeech:〔代〕	expl:我（男性自称）
pronun:まあまあ	writing:null	partOfSpeech:〔副〕	expl:大致，还算
pronun:まあ	writing:null	partOfSpeech:［叹］	expl:嗯，嘿，哎哟
pronun:まいあさ	writing:（毎朝）	partOfSpeech:〔名〕	expl:每天早晨
pronun:まいかい	writing:（毎回）	partOfSpeech:〔名〕	expl:每次，每回
pronun:まいしゅう	writing:（毎週）	partOfSpeech:〔名〕	expl:每个星期
pronun:まいにち	writing:（毎日）	partOfSpeech:〔名〕	expl:每天，每日
pronun:まいばん	writing:（毎晩）	partOfSpeech:〔名〕	expl:每天晚上
pronun:まいりました	writing:（参りました）	partOfSpeech:null	expl:真糟糕，真倒霉
pronun:まいります	writing:（参ります）	partOfSpeech:［动1］	expl:（自谦）来，去
pronun:まえに	writing:（前に）	partOfSpeech:〔副〕	expl:以前
pronun:まえ	writing:（前）	partOfSpeech:〔名〕	expl:前，前面
pronun:まがります	writing:（曲がります）	partOfSpeech:〔动1〕	expl:拐弯，曲折
pronun:まきこみます	writing:（巻き込みます）	partOfSpeech:［动1］	expl:卷入，卷进
pronun:まけます	writing:（負けます）	partOfSpeech:[动2]	expl:输，败
pronun:まこと	writing:（誠）	partOfSpeech:［专］	expl:诚，阿诚
pronun:まご	writing:（孫）	partOfSpeech:［名］	expl:孙子，孙女
pronun:まじめ	writing:null	partOfSpeech:〔形2〕	expl:认真；严肃
pronun:ますます	writing:null	partOfSpeech:［副］	expl:越来越，更加
pronun:まず	writing:null	partOfSpeech:〔副〕	expl:先，首先
pronun:まずい	writing:null	partOfSpeech:〔形1〕	expl:不好吃，难吃
pronun:また	writing:null	partOfSpeech:〔副〕	expl:还，再，又
pronun:まだです	writing:null	partOfSpeech:null	expl:还没有，仍然……没有
pronun:まだまだ	writing:null	partOfSpeech:［副］	expl:还，尚，仍
pronun:まちあいしつ	writing:（待合室）	partOfSpeech:［名］	expl:候诊室，等候室
pronun:まちがい	writing:（間違い）	partOfSpeech:〔名〕	expl:错误，失误
pronun:まちがえます	writing:（間違えます）	partOfSpeech:［动2］	expl:搞错
pronun:まちなみ	writing:（町並み）	partOfSpeech:［名］	expl:市容，街道，街景
pronun:まちます	writing:（待ちます）	partOfSpeech:〔动1〕	expl:等待，等候
pronun:まち	writing:（町）	partOfSpeech:〔名〕	expl:城市，街道
pronun:まっすぐ	writing:null	partOfSpeech:〔副〕	expl:径直，笔直
pronun:まとめて	writing:null	partOfSpeech:null	expl:一下子，一起，汇总，汇集
pronun:まど	writing:（窓）	partOfSpeech:〔名〕	expl:窗，窗户
pronun:まにあいます	writing:（間に合います）	partOfSpeech:［动1］	expl:来得及，赶得上
pronun:まもなく	writing:（間もなく）	partOfSpeech:〔副〕	expl:马上，一会儿，不久
pronun:まもります	writing:（守ります）	partOfSpeech:［动1］	expl:遵守，保护
pronun:まよいます	writing:（迷います）	partOfSpeech:〔动1〕	expl:犹豫，难以决定
pronun:まるで	writing:null	partOfSpeech:［副］	expl:好像，就像
pronun:まわします	writing:（回します）	partOfSpeech:［动1］	expl:转，传送，传递
pronun:まわります	writing:（回ります）	partOfSpeech:［动1］	expl:走访；转；绕弯
pronun:まわり	writing:（周り）	partOfSpeech:［名］	expl:一带，周围
pronun:まんが	writing:（漫画）	partOfSpeech:〔名〕	expl:漫画
pronun:みえます	writing:（見えます）	partOfSpeech:［动2］	expl:看到，看得见
pronun:みおくり	writing:（見送り）	partOfSpeech:〔名〕	expl:送行，送别
pronun:みがきます	writing:（磨きます）	partOfSpeech:［动1］	expl:刷，擦
pronun:みぎ	writing:（右）	partOfSpeech:〔名〕	expl:右，右边
pronun:みこみます	writing:（見込みます）	partOfSpeech:［动1］	expl:预料，估计
pronun:みじかい	writing:（短い）	partOfSpeech:〔形1〕	expl:短，短暂
pronun:みずうみ	writing:（湖）	partOfSpeech:［名］	expl:湖
pronun:みず	writing:（水）	partOfSpeech:〔名〕	expl:水，凉水
pronun:みせます	writing:（見せます）	partOfSpeech:〔动2〕	expl:给～看；出示
pronun:みそしる	writing:（みそ汁）	partOfSpeech:［名］	expl:酱汤
pronun:みち	writing:（道）	partOfSpeech:〔名〕	expl:路，道路
pronun:みつかります	writing:（見つかります）	partOfSpeech:［动1］	expl:找到，发现　　　　　　　　　　　　　　　
pronun:みつけます	writing:（見つけます）	partOfSpeech:［动2］	expl:找到，发现，看见
pronun:みどり	writing:（緑）	partOfSpeech:〔名〕	expl:绿，绿色
pronun:みなさん	writing:（皆さん）	partOfSpeech:〔名〕	expl:大家，诸位
pronun:みます	writing:（見ます）	partOfSpeech:〔动2〕	expl:看
pronun:みみ	writing:（耳）	partOfSpeech:［名］	expl:耳朵
pronun:みょうにち	writing:（明日）	partOfSpeech:［名］	expl:明天
pronun:みりょく	writing:（魅力）	partOfSpeech:［名］	expl:吸引力，魅力
pronun:みわたします	writing:（見渡します）	partOfSpeech:［动1］	expl:眺望，远眺
pronun:みんな	writing:null	partOfSpeech:〔名〕	expl:大家
pronun:むかいます	writing:（向かいます）	partOfSpeech:［动1］	expl:往～去
pronun:むかえます	writing:（迎えます）	partOfSpeech:［动2］	expl:迎接
pronun:むかし	writing:（昔）	partOfSpeech:［名］	expl:以前
pronun:むすこ	writing:（息子）	partOfSpeech:〔名〕	expl:儿子
pronun:むすびます	writing:(結びます)	partOfSpeech:［动1］	expl:连接，系
pronun:むすめ	writing:（娘）	partOfSpeech:［名］	expl:女儿
pronun:むずかしい	writing:（難しい）	partOfSpeech:〔形1〕	expl:难
pronun:むら	writing:（村）	partOfSpeech:［名］	expl:村子，村庄
pronun:むりをします	writing:（無理をします）	partOfSpeech:null	expl:勉强
pronun:むり	writing:（無理）	partOfSpeech:〔名〕	expl:勉强，难以办到
pronun:めいさんひん	writing:（名産品）	partOfSpeech:〔名〕	expl:特产，名产
pronun:めいわく	writing:（迷惑）	partOfSpeech:［名］	expl:麻烦
pronun:めがね	writing:（眼鏡）	partOfSpeech:〔名〕	expl:眼镜
pronun:めざまし	writing:（目覚まし）	partOfSpeech:［名］	expl:闹钟；叫醒
pronun:めしあがります	writing:（召し上がります）	partOfSpeech:［动1］	expl:（尊他）吃，喝
pronun:めずらしい	writing:（珍しい）	partOfSpeech:［形1］	expl:珍奇，新奇
pronun:めんきょしょう	writing:（免許証）	partOfSpeech:［名］	expl:许可证，执照
pronun:めんせつ	writing:（面接）	partOfSpeech:［名］	expl:面试
pronun:めんぜいてん	writing:（免税店）	partOfSpeech:［名］	expl:免税店
pronun:め	writing:（目）	partOfSpeech:〔名〕	expl:眼，眼睛
pronun:もう	writing:null	partOfSpeech:〔副〕	expl:已经
pronun:もういちど	writing:（もう一度）	partOfSpeech:〔副〕	expl:再一次
pronun:もうしこみしょ	writing:（申込書）	partOfSpeech:〔名〕	expl:申请书
pronun:もうしで	writing:（申し出）	partOfSpeech:［名］	expl:申请，提议
pronun:もうします	writing:（申します）	partOfSpeech:〔动1〕	expl:是，说，讲，告诉
pronun:もうしわけございません	writing:（申し訳ございません）	partOfSpeech:null	expl:非常抱歉
pronun:もうすぐ	writing:null	partOfSpeech:〔副〕	expl:马上
pronun:もうすこし	writing:（もう少し）	partOfSpeech:null	expl:再～一点
pronun:もくようび	writing:（木曜日）	partOfSpeech:〔名〕	expl:星期四
pronun:もしかしたら	writing:null	partOfSpeech:［副］	expl:也许
pronun:もしもし	writing:null	partOfSpeech:〔叹〕	expl:喂
pronun:もし	writing:null	partOfSpeech:［副］	expl:如果，假如
pronun:もちあるきます	writing:（持ち歩きます）	partOfSpeech:［动1］	expl:携带，拿着走
pronun:もちかえり	writing:(持ち帰り)	partOfSpeech:［名］	expl:打包，带回
pronun:もちます	writing:（持ちます）	partOfSpeech:〔动1〕	expl:有，拥有，持有
pronun:もちろん	writing:null	partOfSpeech:〔副〕	expl:当然，不用说
pronun:もったいない	writing:null	partOfSpeech:［形1］	expl:可惜，浪费，过分
pronun:もっと	writing:null	partOfSpeech:〔副〕	expl:更加，更
pronun:もっとも	writing:（最も）	partOfSpeech:［副］	expl:最
pronun:もとめます	writing:（求めます）	partOfSpeech:［动2］	expl:要求；追求；寻求
pronun:もどします	writing:(戻します)	partOfSpeech:［动1］	expl:放回，返还，返回
pronun:もどります	writing:（戻ります）	partOfSpeech:［动1］	expl:返回，回到
pronun:もの	writing:（物）	partOfSpeech:〔名〕	expl:物品，东西
pronun:もの	writing:（者）	partOfSpeech:［名］	expl:人，～的人
pronun:もの	writing:null	partOfSpeech:［名］	expl:东西，事物
pronun:もみじ	writing:（紅葉）	partOfSpeech:〔名〕	expl:红叶
pronun:もよう	writing:（模様）	partOfSpeech:〔名〕	expl:花纹，纹案
pronun:もらいます	writing:null	partOfSpeech:〔动1〕	expl:拿到，得到
pronun:もり	writing:（森）	partOfSpeech:〔专〕	expl:森
pronun:もれます	writing:（漏れます）	partOfSpeech:［动2］	expl:漏，泄漏
pronun:もんだい	writing:（問題）	partOfSpeech:〔名〕	expl:问题
pronun:もん	writing:（門）	partOfSpeech:［名］	expl:城门，门，大门
pronun:やがいコンサート	writing:（野外～）	partOfSpeech:［名］	expl:露天音乐会
pronun:やきとり	writing:（焼き鳥）	partOfSpeech:〔名〕	expl:烤鸡肉串
pronun:やきます	writing:(焼きます)	partOfSpeech:［动1］	expl:烤，烧，烧毁
pronun:やきゅうじょう	writing:（野球場）	partOfSpeech:［名］	expl:棒球场
pronun:やきゅう	writing:（野球）	partOfSpeech:〔名〕	expl:棒球
pronun:やくします	writing:（訳します）	partOfSpeech:［动1］	expl:翻译
pronun:やくしゃ	writing:（役者）	partOfSpeech:［名］	expl:演员
pronun:やくそくします	writing:（約束～）	partOfSpeech:［动3］	expl:约定
pronun:やくだちます	writing:（役立ちます）	partOfSpeech:［动1］	expl:有用，有益
pronun:やくにたちます	writing:（役に立ちます）	partOfSpeech:null	expl:有用
pronun:やけどします	writing:（火傷～）	partOfSpeech:［动3］	expl:烫伤，烧伤
pronun:やけます	writing:（焼けます）	partOfSpeech:［动2］	expl:着火，燃烧
pronun:やさい	writing:（野菜）	partOfSpeech:〔名〕	expl:蔬菜
pronun:やさしい	writing:（優しい）	partOfSpeech:〔形1〕	expl:和蔼，温和，体贴
pronun:やさしい	writing:（易しい）	partOfSpeech:〔形1〕	expl:容易
pronun:やすい	writing:（安い）	partOfSpeech:〔形1〕	expl:便宜
pronun:やすみます	writing:（休みます）	partOfSpeech:〔动1〕	expl:休息
pronun:やすみ	writing:（休み）	partOfSpeech:〔名〕	expl:休息
pronun:やせます	writing:null	partOfSpeech:［动2］	expl:瘦
pronun:やっきょく	writing:（薬局）	partOfSpeech:〔名〕	expl:药店
pronun:やっと	writing:null	partOfSpeech:〔副〕	expl:好不容易，终于
pronun:やっぱり	writing:null	partOfSpeech:〔副〕	expl:仍然，还是
pronun:やといます	writing:（雇います）	partOfSpeech:［动1］	expl:雇佣
pronun:やね	writing:（屋根）	partOfSpeech:［名］	expl:屋顶，房顶
pronun:やはり	writing:null	partOfSpeech:〔副〕	expl:仍然，还是
pronun:やぶります	writing:（破ります）	partOfSpeech:［动1］	expl:爽约，打破
pronun:やまだ	writing:（山田）	partOfSpeech:〔专〕	expl:山田
pronun:やま	writing:（山）	partOfSpeech:〔名〕	expl:山
pronun:やみます	writing:null	partOfSpeech:［动1］	expl:停，停息，停止
pronun:やめます	writing:null	partOfSpeech:〔动2〕	expl:戒，停止，放弃
pronun:やめます	writing:（辞めます）	partOfSpeech:［动2］	expl:辞去
pronun:やります	writing:null	partOfSpeech:〔动1〕	expl:做
pronun:やわらかい	writing:（柔らかい）	partOfSpeech:［形1］	expl:柔软
pronun:ゆうえんち	writing:（遊園地）	partOfSpeech:［名］	expl:游乐园
pronun:ゆうがた	writing:（夕方）	partOfSpeech:〔名〕	expl:傍晚
pronun:ゆうしゅう	writing:(優秀)	partOfSpeech:[形2]	expl:优秀，优异
pronun:ゆうしょうします	writing:（優勝～）	partOfSpeech:［动3］	expl:得冠军
pronun:ゆうびんきょく	writing:（郵便局）	partOfSpeech:〔名〕	expl:邮局
pronun:ゆうべ	writing:null	partOfSpeech:〔名〕	expl:昨天晚上
pronun:ゆうめい	writing:（有名）	partOfSpeech:〔形1〕	expl:有名
pronun:ゆうりょう	writing:（有料）	partOfSpeech:［名］	expl:收费
pronun:ゆかた	writing:（浴衣）	partOfSpeech:〔名〕	expl:浴衣，夏季和服
pronun:ゆき	writing:（雪）	partOfSpeech:〔名〕	expl:雪
pronun:ゆしゅつ	writing:（輸出）	partOfSpeech:［名］	expl:出口，输出
pronun:ゆたか	writing:（豊か）	partOfSpeech:［形2］	expl:充裕，丰富
pronun:ゆっくり	writing:null	partOfSpeech:〔副〕	expl:好好地，安静地
pronun:ゆにゅうします	writing:（輸入～）	partOfSpeech:［动3］	expl:进口，输入
pronun:ゆび	writing:（指）	partOfSpeech:〔名〕	expl:手指，指头
pronun:ゆめ	writing:（夢）	partOfSpeech:〔名〕	expl:梦，理想
pronun:よういします	writing:(用意～)	partOfSpeech:［动3］	expl:准备
pronun:ようき	writing:（容器）	partOfSpeech:［名］	expl:容器
pronun:ようこ	writing:（葉子）	partOfSpeech:［专］	expl:叶子
pronun:ようじ	writing:（用事）	partOfSpeech:［名］	expl:事情
pronun:ようふく	writing:（洋服）	partOfSpeech:〔名〕	expl:西服
pronun:よう	writing:（楊）	partOfSpeech:［专］	expl:杨
pronun:よかったです	writing:null	partOfSpeech:null	expl:太好了
pronun:よく	writing:null	partOfSpeech:〔副〕	expl:经常，常常
pronun:よこはま	writing:（横浜）	partOfSpeech:〔专〕	expl:横滨
pronun:よこ	writing:（横）	partOfSpeech:〔名〕	expl:旁边，侧面
pronun:よごします	writing:（汚します）	partOfSpeech:［动1］	expl:弄脏
pronun:よごれます	writing:（汚れます）	partOfSpeech:[动2]	expl:脏
pronun:よさ	writing:null	partOfSpeech:［名］	expl:长处，好处
pronun:よしだ	writing:（吉田）	partOfSpeech:〔专〕	expl:吉田
pronun:よせぎざいく	writing:（寄木細工）	partOfSpeech:〔名〕	expl:木片儿拼花工艺品
pronun:よっておき	writing:null	partOfSpeech:［名］	expl:珍藏，私藏
pronun:よてい	writing:（予定）	partOfSpeech:〔名〕	expl:预约
pronun:よなか	writing:（夜中）	partOfSpeech:〔名〕	expl:午夜，半夜
pronun:よびます	writing:（呼びます）	partOfSpeech:〔动1〕	expl:呼喊
pronun:よみます	writing:（読みます）	partOfSpeech:〔动1〕	expl:读
pronun:よやくします	writing:（予約～）	partOfSpeech:〔动3〕	expl:预约
pronun:よります	writing:（寄ります）	partOfSpeech:［动1］	expl:顺便去；靠近
pronun:よる	writing:（夜）	partOfSpeech:〔名〕	expl:晚上，夜里，夜晚
pronun:よろこびます	writing:（喜びます）	partOfSpeech:［动1］	expl:喜悦，高兴
pronun:よろしくおつたえください	writing:（～お伝えください）	partOfSpeech:null	expl:请代问好
pronun:よろしくおねがいします	writing:（～お願いします）	partOfSpeech:null	expl:请多关照
pronun:よわい	writing:（弱い）	partOfSpeech:［形1］	expl:弱，脆弱，柔弱
pronun:らいげつ	writing:（来月）	partOfSpeech:〔名〕	expl:下个月
pronun:らいしゅう	writing:（来週）	partOfSpeech:〔名〕	expl:下个星期
pronun:らいねん	writing:（来年）	partOfSpeech:〔名〕	expl:明年
pronun:らく	writing:（楽）	partOfSpeech:［形2］	expl:容易，简易；快乐，轻松
pronun:らんぼう	writing:（乱暴）	partOfSpeech:［形2］	expl:粗暴
pronun:りかいします	writing:（理解～）	partOfSpeech:［动3］	expl:理解
pronun:りそうてき	writing:（理想的）	partOfSpeech:［形2］	expl:理想
pronun:りっぱ	writing:（立派）	partOfSpeech:〔形1〕	expl:美观，杰出
pronun:りゅうえい	writing:（劉英）	partOfSpeech:［专］	expl:刘英
pronun:りゅうがくします	writing:（留学～）	partOfSpeech:［动3］	expl:留学
pronun:りゅうがくせい	writing:（留学生）	partOfSpeech:〔名〕	expl:留学生
pronun:りゅうこうします	writing:（流行～）	partOfSpeech:［动3］	expl:流行
pronun:りょうきん	writing:（料金）	partOfSpeech:［名］	expl:费用
pronun:りょうしん	writing:（両親）	partOfSpeech:〔名〕	expl:父母，双亲
pronun:りょうり	writing:（料理）	partOfSpeech:〔名〕	expl:菜肴，饭菜
pronun:りょう	writing:（寮）	partOfSpeech:〔名〕	expl:宿舍
pronun:りょかん	writing:（旅館）	partOfSpeech:〔名〕	expl:旅馆，旅店
pronun:りょくちゃ	writing:（緑茶）	partOfSpeech:〔名〕	expl:绿茶
pronun:りょこうがいしゃ	writing:（旅行会社）	partOfSpeech:〔名〕	expl:旅行社
pronun:りょこうしゃ	writing:(旅行者)	partOfSpeech:［名］	expl:旅行社
pronun:りょこうしゃ	writing:（旅行者）	partOfSpeech:［名］	expl:旅行者
pronun:りょこうよてい	writing:（旅行予定）	partOfSpeech:［名］	expl:旅行计划
pronun:りょこうガイド	writing:（旅行～）	partOfSpeech:〔名〕	expl:旅行导游
pronun:りょこう	writing:（旅行）	partOfSpeech:〔名〕	expl:旅行
pronun:りようします	writing:（利用～）	partOfSpeech:［动3］	expl:利用
pronun:りようしゃ	writing:（利用者）	partOfSpeech:［名］	expl:利用者
pronun:り	writing:（李）	partOfSpeech:〔专〕	expl:李
pronun:るすにします	writing:（留守にします）	partOfSpeech:null	expl:不在家，无人在家
pronun:るす	writing:（留守）	partOfSpeech:［名］	expl:不在家
pronun:るりがわら	writing:（瑠璃瓦）	partOfSpeech:［名］	expl:琉璃瓦
pronun:れいぞうこ	writing:（冷蔵庫）	partOfSpeech:〔名〕	expl:冰箱
pronun:れいとうしょくひん	writing:（冷凍食品）	partOfSpeech:［名］	expl:冷冻食品
pronun:れいぶん	writing:（例文）	partOfSpeech:［名］	expl:例句
pronun:れきし	writing:（歴史）	partOfSpeech:［名］	expl:历史
pronun:れっしゃ	writing:（列車）	partOfSpeech:［名］	expl:火车
pronun:れんあい	writing:（恋愛）	partOfSpeech:〔名〕	expl:恋爱
pronun:れんきゅう	writing:（連休）	partOfSpeech:〔名〕	expl:连休
pronun:れんしゅうします	writing:（練習～）	partOfSpeech:〔动3〕	expl:练习
pronun:れんらくしあす	writing:（連絡～）	partOfSpeech:〔动3〕	expl:联系
pronun:ろじん	writing:（魯迅）	partOfSpeech:［专］	expl:鲁迅
pronun:ろじ	writing:（路地）	partOfSpeech:［名］	expl:小巷，弄堂
pronun:ろんぶん	writing:(論文)	partOfSpeech:［名］	expl:论文
pronun:わあ	writing:null	partOfSpeech:〔叹〕	expl:哇
pronun:わかい	writing:（若い）	partOfSpeech:〔形1〕	expl:年轻
pronun:わかりました	writing:（分かりました）	partOfSpeech:null	expl:明白了
pronun:わかります	writing:（分かります）	partOfSpeech:〔动1〕	expl:懂，明白
pronun:わかりません	writing:（分かりません）	partOfSpeech:null	expl:不知道
pronun:わすれます	writing:（忘れます）	partOfSpeech:〔动2〕	expl:忘记
pronun:わすれもの	writing:（忘れ物）	partOfSpeech:［名］	expl:忘记的东西，遗忘的物品
pronun:わたくしども	writing:（私ども）	partOfSpeech:［代］	expl:我们
pronun:わたくし	writing:（私）	partOfSpeech:［代］	expl:我
pronun:わたします	writing:（渡します）	partOfSpeech:〔动1〕	expl:交给
pronun:わたります	writing:（渡ります）	partOfSpeech:〔动1〕	expl:过（桥，河），穿过（马路）
pronun:わらいごえ	writing:（笑い声）	partOfSpeech:［名］	expl:笑声
pronun:わらいます	writing:（笑います）	partOfSpeech:〔动1〕	expl:笑
pronun:わらい	writing:（笑い）	partOfSpeech:［名］	expl:笑
pronun:わります	writing:（割ります）	partOfSpeech:［动1］	expl:割开，打破，打坏
pronun:わるい	writing:（悪い）	partOfSpeech:〔形1〕	expl:不好，坏
pronun:われます	writing:（割れます）	partOfSpeech:[动2]	expl:裂开，破裂
pronun:われわれ	writing:（我々）	partOfSpeech:［代］	expl:我们
pronun:をたし	writing:null	partOfSpeech:〔代〕	expl:我
pronun:アイスクリーム	writing:null	partOfSpeech:〔名〕	expl:冰激凌
pronun:アイティーさんぎょう	writing:（ＩＴ産業）	partOfSpeech:〔名〕	expl:IT产业，信息技术产业
pronun:アイディーカード	writing:（ＩＤ～）	partOfSpeech:〔名〕	expl:身份证件
pronun:アクセス	writing:null	partOfSpeech:［名］	expl:连接，衔接
pronun:アニメ	writing:null	partOfSpeech:［名］	expl:动画片
pronun:アパート	writing:null	partOfSpeech:〔名〕	expl:公寓
pronun:アメリカ	writing:null	partOfSpeech:〔专〕	expl:美国
pronun:アメリカじん	writing:（～人）	partOfSpeech:〔名〕	expl:美国人
pronun:アラーム	writing:null	partOfSpeech:［名］	expl:闹钟，闹铃
pronun:アルバイト	writing:null	partOfSpeech:［名］	expl:打工，副业，工读
pronun:アルバム	writing:null	partOfSpeech:〔名〕	expl:相册
pronun:アルファベット	writing:null	partOfSpeech:［名］	expl:英语字母，拉丁字母
pronun:イチゴ	writing:null	partOfSpeech:〔名〕	expl:草莓
pronun:イメージ	writing:null	partOfSpeech:［名］	expl:形象，印象
pronun:インタビュー	writing:null	partOfSpeech:［名］	expl:采访
pronun:インターネット	writing:null	partOfSpeech:［名］	expl:互联网
pronun:インパクト	writing:null	partOfSpeech:［名］	expl:冲击力，力量感
pronun:インフルエンザ	writing:null	partOfSpeech:［名］	expl:流感，流行性感冒
pronun:ウイスキー	writing:null	partOfSpeech:〔名〕	expl:威士忌
pronun:ウーロンちゃ	writing:（～茶）	partOfSpeech:〔名〕	expl:乌龙茶
pronun:エスカレーター	writing:null	partOfSpeech:〔名〕	expl:自动扶梯
pronun:エベレスト	writing:null	partOfSpeech:〔专〕	expl:珠穆朗玛峰
pronun:エレベーター	writing:null	partOfSpeech:[名]	expl:电梯
pronun:エンジン	writing:null	partOfSpeech:［名］	expl:发动机，引擎
pronun:エーエム	writing:(am)	partOfSpeech:〔名〕	expl:上午
pronun:オイル	writing:null	partOfSpeech:［名］	expl:油，润滑油
pronun:オリンピック	writing:null	partOfSpeech:［名］	expl:奥运会，奥林匹克
pronun:オーストラリアじん	writing:（～人）	partOfSpeech:〔名〕	expl:澳大利亚人
pronun:オーストラリア	writing:null	partOfSpeech:［专］	expl:澳大利亚
pronun:オートバイ	writing:null	partOfSpeech:［名］	expl:摩托车
pronun:カキ	writing:null	partOfSpeech:［名］	expl:柿子
pronun:カササギ	writing:null	partOfSpeech:［名］	expl:喜鹊
pronun:カタログ	writing:null	partOfSpeech:［名］	expl:目录
pronun:カメラ	writing:null	partOfSpeech:〔名〕	expl:照相机
pronun:カラオケ	writing:null	partOfSpeech:〔名〕	expl:卡拉OK
pronun:カレンダー	writing:null	partOfSpeech:［名］	expl:挂历，日历
pronun:カレー	writing:null	partOfSpeech:〔名〕	expl:咖喱（饭）
pronun:カレーライス	writing:null	partOfSpeech:［名］	expl:咖喱饭
pronun:カーテン	writing:null	partOfSpeech:［名］	expl:窗帘，帘子
pronun:ガラス	writing:null	partOfSpeech:［名］	expl:玻璃，玻璃杯
pronun:ガレージ	writing:null	partOfSpeech:〔名〕	expl:车库，汽车房
pronun:キム	writing:（金）	partOfSpeech:〔专〕	expl:金
pronun:キャンプ	writing:null	partOfSpeech:〔名〕	expl:野营
pronun:ギター	writing:null	partOfSpeech:〔名〕	expl:吉他
pronun:ギョーザパーテイー	writing:（饺子～）	partOfSpeech:［名］	expl:饺子宴
pronun:ギョーザ	writing:（餃子）	partOfSpeech:〔名〕	expl:饺子
pronun:クジラ	writing:null	partOfSpeech:［名］	expl:鲸
pronun:クラシック	writing:null	partOfSpeech:〔名〕	expl:西方古典音乐
pronun:クラス	writing:null	partOfSpeech:〔名〕	expl:班级
pronun:クリスマス	writing:null	partOfSpeech:〔名〕	expl:圣诞节
pronun:クリスマスシリー	writing:null	partOfSpeech:〔名〕	expl:圣诞树
pronun:クレジットカード	writing:null	partOfSpeech:［名］	expl:信用卡
pronun:クーラー	writing:null	partOfSpeech:〔名〕	expl:空调
pronun:グラウンド	writing:null	partOfSpeech:［名］	expl:操场，运动场
pronun:グラス	writing:null	partOfSpeech:〔名〕	expl:玻璃杯
pronun:グラフ	writing:null	partOfSpeech:［名］	expl:图表
pronun:ケーキ	writing:null	partOfSpeech:〔名〕	expl:蛋糕
pronun:コストグウン	writing:null	partOfSpeech:［名］	expl:降低成本
pronun:コップ	writing:null	partOfSpeech:［名］	expl:杯子，杯
pronun:コピーき	writing:（～機）	partOfSpeech:［名］	expl:复印机
pronun:コピーします	writing:null	partOfSpeech:〔动3〕	expl:复印
pronun:コンクリート	writing:null	partOfSpeech:［名］	expl:混凝土，水泥
pronun:コンサート	writing:null	partOfSpeech:〔名〕	expl:音乐会
pronun:コンビニ	writing:null	partOfSpeech:〔名〕	expl:便利店 
pronun:コンピュータ	writing:null	partOfSpeech:〔名〕	expl:计算机，电脑
pronun:コース	writing:null	partOfSpeech:〔名〕	expl:路线，滑道
pronun:コート	writing:null	partOfSpeech:〔名〕	expl:风衣，大衣
pronun:コーヒー	writing:null	partOfSpeech:〔名〕	expl:咖啡
pronun:コーラ	writing:null	partOfSpeech:〔名〕	expl:可乐
pronun:ゴルフ	writing:null	partOfSpeech:〔名〕	expl:高尔夫球
pronun:ゴーカート	writing:null	partOfSpeech:［名］	expl:游戏汽车，玩具汽车
pronun:ゴールデンウィーク	writing:null	partOfSpeech:〔名〕	expl:黄金周
pronun:サイズ	writing:null	partOfSpeech:［名］	expl:大小，尺寸
pronun:サイレン	writing:null	partOfSpeech:［名］	expl:警笛，警报器
pronun:サッカー	writing:null	partOfSpeech:〔名〕	expl:足球
pronun:サッカーボール	writing:null	partOfSpeech:〔名〕	expl:足球
pronun:サボります	writing:null	partOfSpeech:［动1］	expl:逃学，怠工
pronun:サメ	writing:null	partOfSpeech:［名］	expl:鲨鱼
pronun:サンダル	writing:null	partOfSpeech:［名］	expl:凉鞋
pronun:サービス	writing:null	partOfSpeech:〔名〕	expl:服务
pronun:サービスセンター	writing:null	partOfSpeech:［名］	expl:维修服务中心
pronun:ザーザー	writing:null	partOfSpeech:［副］	expl:（雨）哗啦哗啦
pronun:シャツ	writing:null	partOfSpeech:〔名〕	expl:衬衫
pronun:シャワー	writing:null	partOfSpeech:〔名〕	expl:淋浴
pronun:シャンハイ	writing:（上海）	partOfSpeech:〔专〕	expl:上海
pronun:シュートします	writing:null	partOfSpeech:［动3］	expl:（足球）射门，投篮
pronun:ショパン	writing:null	partOfSpeech:〔专〕	expl:肖邦
pronun:シルク	writing:null	partOfSpeech:〔名〕	expl:丝绸
pronun:シンプル	writing:null	partOfSpeech:〔形2〕	expl:单纯，简洁
pronun:シーエスコンス	writing:（CS公司）	partOfSpeech:［专］	expl:CS公司
pronun:シーズン	writing:null	partOfSpeech:〔名〕	expl:季节
pronun:シーディー	writing:（ＣＤ）	partOfSpeech:〔名〕	expl:CD
pronun:ジェーアール	writing:（ＪＲ）	partOfSpeech:〔专〕	expl:JR
pronun:ジェーシーきかく	writing:（ＪＣ企画）	partOfSpeech:〔专〕	expl:JC策划公司
pronun:ジェーシーじどうしゃ	writing:（JC自動車）	partOfSpeech:［专］	expl:JC汽车公司
pronun:ジャスミンちゃ	writing:（～茶）	partOfSpeech:〔名〕	expl:茉莉花茶
pronun:ジャズ	writing:null	partOfSpeech:［名］	expl:爵士乐
pronun:ジュース	writing:null	partOfSpeech:〔名〕	expl:果汁
pronun:ジョギング	writing:null	partOfSpeech:〔名〕	expl:慢跑，跑步
pronun:ジョンソン	writing:null	partOfSpeech:〔专〕	expl:约翰逊
pronun:スイカ	writing:null	partOfSpeech:［名］	expl:西瓜
pronun:スイス	writing:null	partOfSpeech:〔专〕	expl:瑞士
pronun:スイッチ	writing:null	partOfSpeech:〔名〕	expl:开关
pronun:スカート	writing:null	partOfSpeech:〔名〕	expl:裙子
pronun:スキー	writing:null	partOfSpeech:〔名〕	expl:滑雪
pronun:スキーじょう	writing:（～場）	partOfSpeech:〔名〕	expl:滑雪场
pronun:スケジュールひょう	writing:（～表）	partOfSpeech:〔名〕	expl:日程表
pronun:スケッチします	writing:null	partOfSpeech:［动3］	expl:素描，写生
pronun:スケート	writing:null	partOfSpeech:〔名〕	expl:滑冰，溜冰
pronun:スタッフ	writing:null	partOfSpeech:［名］	expl:职员，同事
pronun:ストレス	writing:null	partOfSpeech:［名］	expl:精神紧张状态
pronun:スピーチ	writing:null	partOfSpeech:［名］	expl:演说，演讲
pronun:スピード	writing:null	partOfSpeech:［名］	expl:速度
pronun:スプーン	writing:null	partOfSpeech:〔名〕	expl:勺子
pronun:スペインご	writing:（～語）	partOfSpeech:〔名〕	expl:西班牙语
pronun:スポーツ	writing:null	partOfSpeech:〔名〕	expl:体育，运动
pronun:スポーツようひん	writing:（～用品）	partOfSpeech:［名］	expl:体育用品
pronun:スポーツセンター	writing:null	partOfSpeech:［名］	expl:体育中心
pronun:スミス	writing:null	partOfSpeech:〔专〕	expl:史密斯
pronun:スワトウ	writing:null	partOfSpeech:〔专〕	expl:汕头
pronun:スーツケース	writing:null	partOfSpeech:［名］	expl:旅行箱
pronun:スーツ	writing:null	partOfSpeech:［名］	expl:西服，女套装
pronun:スーパー	writing:null	partOfSpeech:［名］	expl:超市
pronun:スーブ	writing:null	partOfSpeech:〔名〕	expl:汤
pronun:ズボン	writing:null	partOfSpeech:［名］	expl:裤子
pronun:セットします	writing:null	partOfSpeech:［动3］	expl:设定，设置
pronun:セーター	writing:null	partOfSpeech:〔名〕	expl:毛衣
pronun:ソフト	writing:null	partOfSpeech:［名］	expl:软件
pronun:タイムサービス	writing:null	partOfSpeech:〔名〕	expl:时段廉价销售
pronun:タイヤ	writing:null	partOfSpeech:［名］	expl:轮胎
pronun:タイ	writing:null	partOfSpeech:［专］	expl:泰国
pronun:タクシー	writing:null	partOfSpeech:〔名〕	expl:出租车
pronun:タバコ	writing:null	partOfSpeech:〔名〕	expl:烟，烟草
pronun:ダイエット	writing:null	partOfSpeech:［名］	expl:减肥
pronun:ダイナマイト	writing:null	partOfSpeech:［名］	expl:炸药
pronun:ダンス	writing:null	partOfSpeech:［名］	expl:跳舞，舞
pronun:チェックインします	writing:null	partOfSpeech:［动3］	expl:办理入住手续
pronun:チエックします	writing:null	partOfSpeech:［动3］	expl:确认
pronun:チケット	writing:null	partOfSpeech:〔名〕	expl:票
pronun:チョコレート	writing:null	partOfSpeech:〔名〕	expl:巧克力
pronun:チンタオビール	writing:（青岛～）	partOfSpeech:［专］	expl:青岛啤酒
pronun:チーズ	writing:null	partOfSpeech:〔名〕	expl:干酪
pronun:チーム	writing:null	partOfSpeech:［名］	expl:队，团体
pronun:テイーシャツ	writing:（T～）	partOfSpeech:［名］	expl:T恤衫
pronun:テニス	writing:null	partOfSpeech:〔名〕	expl:网球
pronun:テレビ	writing:null	partOfSpeech:〔名〕	expl:电视机
pronun:テレビこうざ	writing:（～講座）	partOfSpeech:［名］	expl:电视讲座
pronun:テレビゲーム	writing:null	partOfSpeech:［名］	expl:电子游戏
pronun:テープ	writing:null	partOfSpeech:［名］	expl:磁带，音像带
pronun:ディズニーランド	writing:null	partOfSpeech:〔专〕	expl:迪斯尼乐园
pronun:デザイナー	writing:null	partOfSpeech:〔名〕	expl:设计者，设计家
pronun:デザイン	writing:null	partOfSpeech:〔名〕	expl:设计（图），（制作）图案
pronun:デジカメ	writing:null	partOfSpeech:〔名〕	expl:数码相机
pronun:デパート	writing:null	partOfSpeech:〔名〕	expl:百货商店
pronun:デュポン	writing:null	partOfSpeech:〔专〕	expl:迪蓬
pronun:トイレ	writing:null	partOfSpeech:〔名〕	expl:厕所，盥洗室
pronun:トランク	writing:null	partOfSpeech:［名］	expl:后备箱；手提箱，皮箱
pronun:ドア	writing:null	partOfSpeech:〔名〕	expl:门
pronun:ドライブ	writing:null	partOfSpeech:〔名〕	expl:兜风，开汽车远游
pronun:ドラマ	writing:null	partOfSpeech:〔名〕	expl:连续剧
pronun:ナシ	writing:null	partOfSpeech:〔名〕	expl:梨
pronun:ナンキンろ	writing:（南京路）	partOfSpeech:［专］	expl:南京路
pronun:ニュース	writing:null	partOfSpeech:〔名〕	expl:新闻
pronun:ニュートン	writing:null	partOfSpeech:［专］	expl:牛顿
pronun:ネクタイ	writing:null	partOfSpeech:〔名〕	expl:领带
pronun:ネックレス	writing:null	partOfSpeech:［名］	expl:项链
pronun:ネーミング	writing:null	partOfSpeech:［名］	expl:名称，命名，取名
pronun:ノート	writing:null	partOfSpeech:〔名〕	expl:笔记本，本子
pronun:ノートパソコン	writing:null	partOfSpeech:〔名〕	expl:笔记本电脑
pronun:ノーベル	writing:null	partOfSpeech:［专］	expl:诺贝尔
pronun:ハイキング	writing:null	partOfSpeech:〔名〕	expl:郊游，远足
pronun:ハンカチ	writing:null	partOfSpeech:〔名〕	expl:手绢
pronun:ハンサム	writing:null	partOfSpeech:〔形2〕	expl:英俊，帅气
pronun:ハードスケジュール	writing:null	partOfSpeech:［名］	expl:紧张的日程
pronun:バイク	writing:null	partOfSpeech:〔名〕	expl:摩托车
pronun:バス	writing:null	partOfSpeech:〔名〕	expl:公共汽车
pronun:バスケットボール	writing:null	partOfSpeech:［名］	expl:篮球
pronun:バック	writing:null	partOfSpeech:［名］	expl:背景
pronun:バッグ	writing:null	partOfSpeech:［名］	expl:包，手提包
pronun:バドミントン	writing:null	partOfSpeech:〔名〕	expl:羽毛球
pronun:バナナ	writing:null	partOfSpeech:〔名〕	expl:香蕉
pronun:バラ	writing:null	partOfSpeech:〔名〕	expl:蔷薇，玫瑰
pronun:バン	writing:null	partOfSpeech:〔名〕	expl:面包
pronun:バンダ	writing:null	partOfSpeech:〔名〕	expl:熊猫
pronun:バンフレット	writing:null	partOfSpeech:〔名〕	expl:小册子
pronun:バーゲンかいじょう	writing:（～会場）	partOfSpeech:〔名〕	expl:降价处理大卖场
pronun:バーデン	writing:null	partOfSpeech:［名］	expl:降价出售
pronun:バーベキュー	writing:null	partOfSpeech:〔名〕	expl:户外烧烤
pronun:パイロット	writing:null	partOfSpeech:〔名〕	expl:飞行员
pronun:パク	writing:null	partOfSpeech:［专］	expl:朴
pronun:パスポート	writing:null	partOfSpeech:〔名〕	expl:护照
pronun:パソコン	writing:null	partOfSpeech:〔名〕	expl:个人电脑
pronun:パトカー	writing:null	partOfSpeech:［名］	expl:警车，巡逻车
pronun:パワー	writing:null	partOfSpeech:［名］	expl:能力，力量
pronun:パンクします	writing:null	partOfSpeech:［动3］	expl:轮胎爆裂，撑破
pronun:パーティー	writing:null	partOfSpeech:〔名〕	expl:联欢会
pronun:ヒマワリ	writing:null	partOfSpeech:〔名〕	expl:向日葵
pronun:ビアガーデン	writing:null	partOfSpeech:［名］	expl:庭院式的啤酒店
pronun:ビタミンざい	writing:（～剤）	partOfSpeech:［名］	expl:维生素片剂
pronun:ビデオ	writing:null	partOfSpeech:〔名〕	expl:录像机
pronun:ビル	writing:null	partOfSpeech:〔名〕	expl:大楼，大厦
pronun:ビール	writing:null	partOfSpeech:〔名〕	expl:啤酒
pronun:ピアノ	writing:null	partOfSpeech:〔名〕	expl:钢琴
pronun:ピクニック	writing:null	partOfSpeech:［名］	expl:郊游
pronun:ピザ	writing:null	partOfSpeech:［名］	expl:比萨饼
pronun:ピーエム	writing:(pm)	partOfSpeech:〔名〕	expl:下午
pronun:ファックス	writing:null	partOfSpeech:〔名〕	expl:传真
pronun:フェリー	writing:null	partOfSpeech:〔名〕	expl:渡轮
pronun:フジ	writing:null	partOfSpeech:［名］	expl:紫藤
pronun:フライパン	writing:null	partOfSpeech:［名］	expl:平底锅
pronun:フランス	writing:null	partOfSpeech:〔专〕	expl:法国
pronun:フランスご	writing:（～語）	partOfSpeech:〔名〕	expl:法语
pronun:フランスじん	writing:（～人）	partOfSpeech:〔名〕	expl:法国人
pronun:フリーズします	writing:null	partOfSpeech:［动3］	expl:死机
pronun:フートン	writing:（胡同）	partOfSpeech:［名］	expl:胡同
pronun:ブレゼント	writing:null	partOfSpeech:〔名〕	expl:礼物
pronun:ブローチ	writing:null	partOfSpeech:［名］	expl:胸针
pronun:プラスチック	writing:null	partOfSpeech:［名］	expl:塑胶，塑料
pronun:プラン	writing:null	partOfSpeech:［名］	expl:计划
pronun:プレゼン	writing:null	partOfSpeech:［名］	expl:策划方案说明（会）
pronun:プレゼンテーション	writing:null	partOfSpeech:［名］	expl:策划方案说明（会）
pronun:プール	writing:null	partOfSpeech:〔名〕	expl:游泳池
pronun:ベッド	writing:null	partOfSpeech:〔名〕	expl:床
pronun:ベンチ	writing:null	partOfSpeech:〔名〕	expl:长椅，长凳
pronun:ベートーベン	writing:null	partOfSpeech:〔专〕	expl:贝多芬
pronun:ペキンきたえき	writing:（北京北駅）	partOfSpeech:［专］	expl:北京北站
pronun:ペキンくうこう	writing:（北京空港）	partOfSpeech:［专］	expl:北京机场
pronun:ペキンししゃ	writing:（北京支社）	partOfSpeech:〔专〕	expl:北京分社
pronun:ペキンしょくぶつえん	writing:（北京植物園）	partOfSpeech:［专］	expl:北京植物园
pronun:ペキンだいがく	writing:（北京大学）	partOfSpeech:〔专〕	expl:北京大学
pronun:ペキンにほんごがっこう	writing:（北京日本語学校）	partOfSpeech:［专］	expl:北京日语学校
pronun:ペキンりょこうしゃ	writing:（北京旅行社）	partOfSpeech:〔专〕	expl:北京旅行社
pronun:ペキンタイガース	writing:（北京～）	partOfSpeech:［专］	expl:北京猛虎队＜棒球队名称＞
pronun:ペキン	writing:（北京）	partOfSpeech:〔专〕	expl:北京
pronun:ペットボトル	writing:null	partOfSpeech:［名］	expl:塑料瓶
pronun:ホテル	writing:null	partOfSpeech:〔名〕	expl:宾馆
pronun:ホンコン	writing:（香港）	partOfSpeech:〔专〕	expl:香港
pronun:ホームパーテイー	writing:null	partOfSpeech:［名］	expl:家庭聚会
pronun:ボタン	writing:null	partOfSpeech:［名］	expl:按钮；纽扣
pronun:ボブッス	writing:null	partOfSpeech:〔名〕	expl:流行音乐
pronun:ボリューム	writing:null	partOfSpeech:［名］	expl:音量
pronun:ボート	writing:null	partOfSpeech:〔名〕	expl:小船，小艇
pronun:ボーナス	writing:null	partOfSpeech:［名］	expl:奖金
pronun:ボーリング	writing:null	partOfSpeech:〔名〕	expl:保龄球
pronun:ボールペン	writing:null	partOfSpeech:〔名〕	expl:圆珠笔
pronun:ポスター	writing:null	partOfSpeech:［名］	expl:宣传画，海报
pronun:マフラー	writing:null	partOfSpeech:［名］	expl:围巾
pronun:マラソンたいかい	writing:(～大会)	partOfSpeech:［名］	expl:马拉松大会
pronun:マンション	writing:null	partOfSpeech:〔名〕	expl:（高级）公寓
pronun:マーク	writing:null	partOfSpeech:［名］	expl:符号
pronun:ミカン	writing:null	partOfSpeech:〔名〕	expl:橘子
pronun:メキシコ	writing:null	partOfSpeech:［专］	expl:墨西哥
pronun:メダル	writing:null	partOfSpeech:［名］	expl:纪念章，奖牌
pronun:メモ	writing:null	partOfSpeech:〔名〕	expl:记录
pronun:メール	writing:null	partOfSpeech:〔名〕	expl:邮件
pronun:メールアドレス	writing:null	partOfSpeech:〔名〕	expl:邮件地址
pronun:モデル	writing:null	partOfSpeech:［名］	expl:模特儿
pronun:モノレール	writing:null	partOfSpeech:［名］	expl:单轨铁路，单轨电车
pronun:モーツァルト	writing:null	partOfSpeech:〔专〕	expl:莫扎特
pronun:ユニーク	writing:null	partOfSpeech:〔形2〕	expl:独特，唯一
pronun:ユーフォー	writing:（UFO）	partOfSpeech:［名］	expl:不明飞行物
pronun:ヨウテイアオ	writing:（油条）	partOfSpeech:［名］	expl:油条
pronun:ヨーロッパ	writing:null	partOfSpeech:〔专〕	expl:欧洲
pronun:ライトアップします	writing:null	partOfSpeech:［动3］	expl:景观照明
pronun:ラケット	writing:null	partOfSpeech:〔名〕	expl:球拍
pronun:ラジオ	writing:null	partOfSpeech:〔名〕	expl:收音机
pronun:ラジオたいそう	writing:（～体操）	partOfSpeech:［名］	expl:广播体操
pronun:ラン	writing:null	partOfSpeech:［名］	expl:兰花
pronun:ラーメン	writing:null	partOfSpeech:［名］	expl:面条
pronun:リニアモーターカー	writing:null	partOfSpeech:［名］	expl:磁悬浮列车
pronun:リンゴ	writing:null	partOfSpeech:〔名〕	expl:苹果
pronun:レストラン	writing:null	partOfSpeech:〔名〕	expl:餐馆，西餐馆
pronun:レポート	writing:null	partOfSpeech:〔名〕	expl:报告
pronun:レモン	writing:null	partOfSpeech:［名］	expl:柠檬
pronun:ロッカー	writing:null	partOfSpeech:［名］	expl:橱柜，文件柜
pronun:ロック	writing:null	partOfSpeech:〔名〕	expl:摇滚乐
pronun:ロンドン	writing:null	partOfSpeech:〔专〕	expl:伦敦
pronun:ワイタン	writing:（外灘）	partOfSpeech:［专］	expl:外滩
pronun:ワイン	writing:null	partOfSpeech:〔名〕	expl:葡萄酒
pronun:ワンワン	writing:null	partOfSpeech:［副］	expl:（狗）汪汪（叫）
voclist end.
